a	@
a.m.	{I`em
abandon	@`b{nd@n
abbreviation	@br\i:vi:`{IS@n
ABC	{Ibi:`si:
abdomen	`{bd@m@n
abide	@`bAed
ability	@`bIl@ti:
ablaze	@`bl{Iz
able	`{Ib@l
abnormal	{b`no:m@l
abnormality	{bno:`m{l@ti:
abolish	@`bOlIS
abominable	@`bOmn@b@l
aborigine	{b@`r\IdZ@ni:
abort	@`bo:t
abortion	@`bo:S@n
about	@`b{Ot
above	@`b6v
abrasion	@`br\{IZ@n
abroad	@`br\o:d
abrupt	@`br\6pt
abscess	`{bses
absent	`{bs@nt
absent-minded	{bs@nt`mAend@d
absolute	`{bs@l}:t
absorb	@b`so:b
absorbed	@bzo:bd
abstract	`{bstr\{kt
absurd	@b`s3:d
abuse	@`bj}:z
academy	@k{d@mi:
accelerate	@k`sel@r\{It
accent	`{ksent
accept	@k`sept
access	`{kses
accident	`{ks@d@nt
accommodate	@`kOm@d{It
accompany	@`k6mp@ni:
accomplice	@`k6mpl@s
accord	@`ko:d
accordingly	@`ko:dINli:
account	@`k6{Ont
accountable	@`k{Ont@b@l
accountant	@`k{Ont@nt
accumulate	@`kj}:mj@l{It
accurate	`{kj@r\@t
accuse	@`kj}:z
accustomed	@`k6st@md
ace	{Is
ache	{Ik
achieve	@`tSi:v
acid	`{s@d
acknowledge	@k`nOlIdZ
acne	`{kni:
acoustics	@`k}:stIks
acquaint	@`kw{Int
acquaintance	@`kw{Int@ns
acquire	@`kwAe@
acquit	@`kwIt
acre	`{Ik@
acrobat	`{kr\@b{t
acronym	`{kr\@nIm
across	@`kr\Os
across-the-board	@`kr\OsD@bo:d
acrylic	@`kr\IlIk
ACT	{Isi:`ti:
act	{kt
action	`{kS@n
activate	`{kt@v{It
active	`{ktIv
activity	{k`tIv@ti:
actor	`{kt@
ACTU	{Isi:ti:`j}:
actual	`{ktS}:@l
actually	`{ktS}:@li:
acupuncture	`{kj@p6NktS@
acute	@`kj}:t
acutely	@`kj}:tli:
AD	{I`di:
ad	{d
adapt	@`d{pt
add	{d
addict	`{dIkt
addicted	@`dIkt@d
addition	@`dIS@n
additive	`{d@tIv
address	@`dr\es
adequate	`{d@kw@t
adhesive	@d`hi:sIv
adjacent	@`dZ{Is@nt
adjective	`{dZ@ktIv
adjourn	@`dZ3:n
adjudicate	@`dZ}:d@k{It
adjust	@`dZ6st
adjustment	@`dZ6stm@nt
admin	`{dmIn
administration	@dmIn@`str\{IS@n
admire	@d`mAe@
admission	@d`mIS@n
admit	@d`mIt
admittance	@d`mIt@ns
adolescence	{d@`les@ns
adopt	@`dOpt
adore	@`do:
adult	`{d6lt
adultery	@`d6lt@r\i:
advance	@d`v{ns
advanced	@d`v{nst
advancement	@d`v{nsm@nt
advantage	@d`v{ntIdZ
adventure	@d`ventS@
adverse	`{dv3:s
adversity	@d`v3:s@ti:
advertise	`{dv@tAez
advertisement	@d`v3:t@sm@nt
advice	@d`vAes
advisable	@d`vAez@b@l
advise	@d`vAez
advocate	`{dv@k{It
aerial	`e:r\i:@l
aerobics	e:`r\@}bIks
aerodrome	`e:r\@dr\@}m
aeroplane	`e:r\@pl{In
aerosol	`e:r\@sOl
affair	@`fe:
affect	@`fekt
affectation	{fek`t{IS@n
affected	@`fekt@d
affection	@`fekS@n
affirm	@`f3:m
affirmative	@`f3:m@tIv
affluent	`{fl}:@nt
afford	@`fo:d
afloat	@`fl@}t
afraid	@`fr\{Id
after	`6:ft@
after-effect	`6:ft@r\@fekt
after-hours	`6:ft@r\{O@z
afterlife	`6:ft@lAef
afternoon	6:ft@`n}:n
aftershave	`6:ft@S{Iv
afterwards	`6:ft@w@dz
again	@`gen
against	@`genst
age	{IdZ
aged	{IdZd
ageing	`{IdZIN
ageism	`{IdZIz@m
agency	`{IdZ@nsi:
agenda	@`dZend@
agent	`{IdZ@nt
aggravate	`{gr\@v{It
aggression	@`gr\eS@n
aggressive	@`gr\esIv
aggro	`{gr\@}
agile	`{dZAel
agitate	`{dZ@t{It
agnostic	{g`nOstIk
ago	@`g@}
agony	`{g@ni:
agree	@`gr\i:
agreement	@`gr\i:m@nt
agriculture	`{gr\@k6ltS@
ahead	@`hed
aid	{Id
AIDS	{Idz
aim	{Im
aimless	`{Iml@s
air	e:
aircon	`e:kOn
airconditioning	`e:k@ndIS@nIN
aircraft	`e:kr\6:ft
airfield	e:fi:ld
airlift	`e:lIft
airline	`e:lAen
airmail	`e:m{Il
airport	`e:po:t
aisle	Ael
ajar	@`dZ6:
Al	{l
Alan	{l@n
alarm	@`l6:m
alarmist	@`l6:m@st
album	`{lb@m
alcohol	`{lk@hOl
alcoholic	{lk@hOlIk
ale	{Il
alert	@`l3:t
alfalfa	{lf{lf@
algebra	`{ldZ@br\@
alias	`{Ili:@s
alibi	`{l@bAe
alien	`{Ili:@n
alienate	`{Ili:@n{It
alight	@`lAet
align	@`lAen
alike	@`lAek
alimony	{l@m@ni:
alive	@`lAev
alkali	`{lk@lAe
all	o:l
allege	@`ledZ
allegiance	@`li:dZ@ns
allegory	`{l@g@r\i:
allergy	`{l@dZi:
alleviate	@`li:vi:{It
alley	`{li:
alliance	@`lAe@ns
alligator	{l@g{It@
allocate	`{l@k{It
allot	@`lOt
allow	@`l{O
allowance	@`l{O@ns
allure	@`l}:@
ally	`{lAe
almighty	o:l`mAeti:
almost	`o:lm@}st
alone	@`l@}n
along	@`lON
aloud	@`l{Od
ALP	{Iel`pi:
alphabet	`{lf@bet
alpine	`{lpAen
Alps	{lps
already	o:l`r\edi:
alright	o:l`r\Aet
also	`o:ls@}
altar	`Olt@
alter	`Olt@
altercation	Olt@`k{IS@n
alternate	Ol`t3:n@t
alternative	Ol`t3:n@tIv
although	o:l`D@}
altitude	`{lt@tj}:d
altogether	o:lt@`geD@
aluminium	{lj@`mIni:@m
always	`o:lw{Iz
AM	{I`em
am	{m
AMA	{Iem`{I
amalgamate	@`m{lg@m{It
amass	@`m{s
amateur	`{m@t@
amaze	@`m{Iz
ambassador	{m`b{s@d@
amber	`{mb@
ambiguous	{m`bIgj}:@s
ambition	{m`bIS@n
amble	`{mb@l
ambulance	`{mbj@l@ns
ambush	`{mbUS
Amelia	@mi:li:@
amenable	@`men@b@l
amend	@`mend
amenity	@`men@ti:
amiable	`{Imi:@b@l
amicable	`{mIk@b@l
ammonia	@`m@}ni:@
ammunition	{mj@`nIS@n
amnesia	{m`ni:Z@
among	@`m6N
amongst	@m6Nkst
amorous	`{m@r\@s
amount	@`m{Ont
amphibian	{mfIbi:@n
ample	`{mp@l
amplify	`{mpl@fAe
amputate	`{mpj@t{It
amputee	{mpj@`ti:
amuse	@`mj}:z
amusement	@`mj}:zm@nt
an	{n
anaemia	@`ni:mi:@
anaesthetic	{n@s`TetIk
anal	`{In@l
analgesic	{n@l`dZi:zIk
analogy	@`n{l@dZi:
analysis	@`n{l@s@s
anarchy	`{n@ki:
anatomy	@`n{t@mi:
ancestor	`{nsest@
anchor	`{Nk@
anchorage	`{Nk@r\IdZ
ancient	`{InS@nt
and	{nd
anecdote	`{n@kd@}t
angel	`{IndZ@l
anger	`{Ng@
angle	`{Ng@l
angry	`{Ngr\i:
anguish	`{NgwIS
animal	`{n@m@l
animated	`{n@m{It@d
animosity	{n@`mOs@ti:
ankle	`{Nk@l
annex	`{neks
annexe	`{neks
annihilate	@`nAe@l{It
anniversary	{n@`v3:s@r\i:
announce	@`n{Ons
annoy	@`noI
annual	`{nj}:@l
anonymous	@`nOn@m@s
another	@`n6D@
answer	`{ns@
answered	{ns@d
ant	{nt
antagonise	{n`t{g@nAez
antagonistic	{nt{g@`nIstIk
antenna	{n`ten@
anthem	`{nT@m
anthropologist	{nTr\@`pOl@dZ@st
anti-	`{nti:
antibiotic	{nti:bAe`OtIk
anticipate	{n`tIs@p{It
anticlockwise	{nti:`klOkwAez
antics	`{ntIks
antidote	`{nti:d@}t
antihistamine	{nti:`hIst@mi:n
antipathy	{n`tIp@Ti:
antipodes	{n`tIp@di:z
antiquated	`{nt@kw{It@d
antique	{n`ti:k
antiseptic	{nt@`septIk
antithesis	{n`tIT@s@s
antler	`{ntl@
antonym	`{nt@nIm
anus	`{In@s
anxious	`{NS@s
any	`eni:
anybody	`eni:bOdi:
anyhow	`eni:h{O
anyone	`eni:w6n
anything	`eni:TIN
anyway	`eni:w{I
anywhere	`eni:we:
Anzac	`{nz{k
apart	@`p6:t
apartheid	@`p6:t{It
apartment	@`p6:tm@nt
apartments	@p6:tm@nts
apathy	`{p@Ti:
ape	{Ip
apex	`{Ipeks
apocalypse	@`pOk@lIps
apologise	@`pOl@dZAez
apology	@`pOl@dZi:
apostle	@`pOs@l
apostrophe	@`pOstr\@fi:
appal	@`po:l
apparatus	{p@`r\6:t@s
apparent	@`p{r\@nt
apparently	@p{r\@ntli:
apparition	{p@`r\IS@n
appeal	@`pi:l
appear	@`pI@
appearance	@`pI@r\@ns
appease	@`pi:z
append	@`pend
appendicitis	@pend@`sAet@s
appendix	@`pendIks
appetising	`{p@tAezIN
appetite	`{p@tAet
applause	@`plo:z
apple	`{p@l
appliance	@`plAe@ns
applicable	@`plIk@b@l
applicant	`{pl@k@nt
apply	@`plAe
appoint	@`poInt
appointment	@`poIntm@nt
appreciate	@`pr\i:Si:{It
apprehend	{pr\@`hend
apprehension	{pr\@`henS@n
apprentice	@`pr\ent@s
approach	@`pr\@}tS
approachable	@`pr\@}tS@b@l
appropriate	@`pr\@}pr\i:@t
approval	@`pr\}:v@l
approve	@`pr\}:v
approximate	@`pr\Oks@m@t
Apr.	`{Ipr\@l
April	`{Ipr\@l
apron	`{Ipr\@n
apt	{pt
aptitude	`{pt@tS}:d
aquarium	@`kwe:r\i:@m
Arabic	`{r\@bIk
arbitrary	`6:b@tr\@r\i:
arbitration	6:b@`tr\{IS@n
arc	6:k
arcade	6:`k{Id
arch	6:tS
archaeologist	6:ki:`Ol@dZ@st
archaic	6:`k{IIk
architect	`6:k@tekt
arduous	`6:dZ}:@s
are	6:
area	`e:r\i:@
arena	@`r\i:n@
arguable	`6:gj}:@b@l
argue	`6:gj}:
argument	`6:gj@m@nt
arise	@`r\Aez
aristocracy	{r\@`stOkr\@si:
arithmetic	@`r\ITm@tIk
ark	6:k
arm	6:m
armchair	`6:mtSe:
armed	6:md
armful	`6:mfUl
armhole	`6:mh@}l
armistice	`6:m@st@s
armour	`6:m@
armpit	`6:mpIt
army	`6:mi:
aroma	@`r\@}m@
around	@`r\{Ond
arousal	@`r\{Oz@l
arouse	@`r\{Oz
arrange	@`r\{IndZ
arrangement	@`r\{IndZm@nt
array	@`r\{I
arrest	@`r\est
arrival	@`r\Aev@l
arrive	@`r\Aev
arrogant	`{r\@g@nt
arrow	`{r\@}
arse	6:s
arsenal	`6:s@n@l
arsenic	`6:s@nIk
arson	`6:s@n
art	6:t
artery	`6:t@r\i:
arthritis	6:`Tr\Aet@s
article	`6:tIk@l
artificial	6:t@`fIS@l
artist	`6:t@st
arvo	`6:v@}
as	{z
asbestos	@s`best@s
ascend	@`send
ascent	@`sent
ascertain	{s@`t{In
ash	{S
ashamed	@`S{Imd
aside	@`sAed
ask	6:sk
asked	6:skt
asleep	@`sli:p
asparagus	@`sp{r\@g@s
aspect	`{spekt
asphalt	`{Sfelt
aspire	@`spAe@
aspirin	`{spr\@n
ass	{s
assassin	@`s{s@n
assassinate	@`s{s@n{It
assault	@`sOlt
assemble	@`semb@l
assembly	@`sembli:
assent	@`sent
assert	@`s3:t
assertive	@`s3:tIv
assess	@`ses
asset	`{set
assign	@`sAen
assignment	@`sAenm@nt
assimilate	@`sIm@l{It
assist	@`sIst
associate	@`s@}Si:{It
association	@s@}si:`{IS@n
assortment	@`so:tm@nt
assume	@`sj}:m
assurance	@`So:r\@ns
assure	@`So:
asterisk	`{st@r\Isk
asthma	`{sm@
astonish	@`stOnIS
astound	@`st{Ond
astray	@`str\{I
astrology	@s`tr\Ol@dZi:
astronaut	`{str\@no:t
astronomy	@s`tr\On@mi:
astute	@s`tj}:t
asylum	@`sAel@m
at	{t
ate	{It
atheist	`{ITi:@st
athlete	`{Tli:t
atlas	`{tl@s
ATM	{Iti:`em
atmosphere	`{tm@sfI@
atom	`{t@m
atomic	@`tOmIk
atrocious	@`tr\@}S@s
attach	@`t{tS
attack	@`t{k
attacker	@t{k@
attain	@`t{In
attempt	@`tempt
attend	@`tend
attention	@`tenS@n
attic	`{tIk
attire	@`tAe@
attitude	`{t@tj}:d
attract	@`tr\{kt
attractive	@`tr\{ktIv
attracts	@tr\{ks
attribute	@`tr\Ibj}:t
atypical	{I`tIpIk@l
aubergine	`@}b@Zi:n
auburn	`o:b@n
auction	`OkS@n
audacious	o:`d{IS@s
audible	`o:d@b@l
audience	`o:di:@ns
audio	`o:di:@}
audit	`o:d@t
audition	o:`dIS@n
Aug.	`o:g@st
August	`o:g@st
august	o:`g6st
aunt	6:nt
aura	`o:r\@
auspicious	o:`spIS@s
austere	Os`tI@
australia	@str\{Ili:@
Australia	@str\{Ili:@
Australian	@st`r\{Ilj@n
authentic	o:`TentIk
author	`o:T@
authorise	`o:T@r\Aez
authority	o:`TOr\@ti:
autobiography	o:t@bAe`Ogr\@fi:
autograph	`o:t@gr\{f
automatic	o:t@`m{tIk
automobile	`o:t@m@bi:l
autonomous	o:`tOn@m@s
autopsy	`o:tOpsi:
autumn	`o:t@m
auxiliary	Og`zIlj@r\i:
avail	@`v{Il
available	@`v{Il@b@l
avalanche	`{v@l{nS
Ave	`{v@nj}:
avenge	@`vendZ
avenue	`{v@nj}:
average	`{vr\IdZ
averse	@`v3:s
aversion	@`v3:Z@n
avert	@`v3:t
aviation	{Ivi:`{IS@n
avid	`{v@d
avocado	{v@`k6:d@}
avoid	@`voId
await	@`w{It
awake	@`w{Ik
awaken	@`w{Ik@n
award	@`wo:d
aware	@`we:
away	@`w{I
awe	o:
awful	`o:f@l
awhile	@`wAel
awkward	`o:kw@d
awning	`o:nIN
axe	{ks
axis	`{ks@s
axle	`{ks@l
B	bi:
b	bi:
babble	`b{b@l
baby	`b{Ibi:
babysit	`b{Ibi:sIt
bachelor	`b{tS@l@
back	b{k
backbone	`b{kb@}n
backdate	`b{kd{It
backfire	b{k`fAe@
background	`b{kgr\{Ond
backing	`b{kIN
backlog	`b{klOg
backside	b{k`sAed
backstop	`b{kstOp
backstroke	`b{kstr\@}k
backup	`b{k6p
backward	`b{kw@d
backwards	`b{kw@dz
backyard	b{k`j6:d
bacon	`b{Ik@n
bacteria	b{k`tI@r\i:@
bad	b{d
bade	b{Id
badge	b{dZ
badger	`b{dZ@
badly	b{dli:
baffle	`b{f@l
bag	b{g
baggage	`b{gIdZ
Bahasa	b@h6:s@
bail	b{Il
bait	b{It
bake	b{Ik
balance	`b{l@ns
balanced	`b{l@nst
balcony	`b{lk@ni:
bald	bo:ld
bale	b{Il
ballast	`b{l@st
ballet	`b{l{I
ballot	`b{l@t
balmy	`b6:mi:
bamboozle	b{m`b}:z@l
ban	b{n
band	b{nd
bandaid	`b{nd{Id
bandicoot	`b{ndi:k}:t
bandit	`b{nd@t
bang	b{N
banish	b{nIS
banjo	`b{ndZ@}
bank	b{Nk
bankrupt	`b{Nkr\6pt
banksia	`b{Nksi:@
banner	`b{n@
banquet	`b{Nkw@t
bant	b{nt
baptism	`b{ptIz@m
bar	b6:
barb	b6:b
barbarian	b6:`be:r\i:@n
barbecue	`b6:b@kj}:
barber	`b6:b@
barbiturate	b6:`bItSUr\@t
bare	be:
barely	`be:li:
bargain	`b6:g@n
barge	b6:dZ
baritone	`b{r\@t@}n
bark	b6:k
barn	b6:n
barometer	b@`r\Om@t@
barrack	`b{r\@k
barracks	`b{r\@ks
barrage	`b{r\6:Z
barrel	`b{r\@l
barren	`b{r\@n
barrier	`b{r\i:@
barrister	`b{r\@st@
barrow	`b{r\@}
base	b{Is
baseball	`b{Isbo:l
basement	`b{Ism@nt
bash	b{S
bashful	`b{SfUl
basic	`b{IsIk
basin	`b{Is@n
basis	`b{Is@s
bask	b6:sk
basket	`b6:sk@t
basketball	`b6:sk@tbo:l
bass	b{Is
bassinet	b{s@net
bassinette	b{s@`net
bastard	`b6:st@d
bat	b{t
batch	b{tS
bath	b6:T
bathe	b{ID
bathers	`b{ID@z
bathroom	`b6:Tr\}:m
baths	b6:Dz
baton	`b{t@n
battalion	b@`t{lj@n
batten	`b{t@n
batter	`b{t@
battle	`b{t@l
baulk	bo:k
bawdy	`bo:di:
bawl	bo:l
bay	b{I
bayonet	`b{I@net
bazooka	b@z}:k@
BBQ	`b6:b@kj}:
BC	bi:`si:
be	bi:
beach	bi:tS
beacon	`bi:k@n
bead	bi:d
beak	bi:k
beam	bi:m
bean	bi:n
bear	be:
beard	bI@d
bearing	`be:r\IN
beast	bi:st
beat	bi:t
beaut	bj}:t
beautician	bj}:`tIS@n
beautiful	`bj}:t@f@l
beauty	`bj}:ti:
became	b@`k{Im
because	bi:`ko:z
beckon	`bek@n
become	b@`k6m
becoming	b@`k6mIN
bed	bed
bedding	`bedIN
bedraggled	b@`dr\{g@ld
bedridden	`bedr\Id@n
bedroom	`bedr\}:m
bee	bi:
beef	bi:f
been	bi:n
beer	bI@
before	b@`fo:
befriend	b@`fr\end
beg	beg
began	b@`g{n
begin	b@`gIn
beginner	b@`gIn@
beginning	b@gInIN
begrudge	b@`gr\6dZ
begun	b@`g6n
behalf	b@`h6:f
behave	b@`h{Iv
behind	b@`hAend
beige	b{IZ
being	`bi:IN
belated	b@`l{It@d
belch	beltS
belief	b@`li:f
believe	b@`li:v
belittle	b@`lIt@l
bell	bel
belligerent	b@`lIdZ@r\@nt
bellow	`bel@}
belly	`beli:
bellybutton	`beli:b6t@n
belong	b@`lON
belongings	b@`lONINz
beloved	b@`l6v@d
below	b@`l@}
belt	belt
Ben	ben
bench	bentS
bend	bend
beneath	b@`ni:T
benefactor	`ben@f{kt@
beneficial	ben@`fIS@l
beneficiary	ben@`fIS@r\i:
benefit	`ben@f@t
benevolent	b@`nev@l@nt
benign	b@`nAen
bent	bent
bequeath	b@`kwi:D
bereaved	b@`r\i:vd
bereft	b@`r\eft
beret	`ber\{I
berry	`ber\i:
berserk	b@`z3:k
berth	b3:T
beside	b@`sAed
besides	b@`sAedz
besiege	b@`si:dZ
best	best
bet	bet
betray	b@`tr\{I
bets	bets
better	`bet@
between	b@`twi:n
beverage	`bevr\IdZ
beware	b@`we:
bewildered	b@`wIld@d
bewitch	b@`wItS
beyond	b@`jOnd
biannual	bAe`{nj}:@l
bias	`bAe@s
bib	bIb
Bible	`bAeb@l
bibliography	bIbli:`@gr\@fi:
bicentenary	bAesen`ti:n@r\i:
bicentennial	bAes@n`teni:@l
biceps	`bAeseps
bicker	`bIk@
bicycle	`bAesIk@l
bid	bId
bide	bAed
biennial	bAe`eni:@l
bifocals	bAe`f@}k@lz
big	bIg
bigamy	`bIg@mi:
biggie	`bIgi:
bight	bAet
bigot	`bIg@t
bike	bAek
bikini	b@`ki:ni:
bile	bAel
bilingual	bAe`lINgw@l
bilious	`bIlj@s
bill	bIl
Bill	bIl
billabong	`bIl@bON
billboard	`bIlbo:d
billet	`bIl@t
billiards	`bIlj@dz
billion	`bIlj@n
billow	`bIl@}
billy	`bIli:
bin	bIn
bind	bAend
bindi-eye	`bIndi:Ae
bingo	`bINg@}
binoculars	b@`nOkj@l@z
biodegradable	bAe@}d@`gr\{Id@b@l
biography	bAe`Ogr\@fi:
biologist	bAe`Ol@dZ@st
biopsy	`bAeOpsi:
bird	b3:d
biro	`bAer\@}
birth	b3:T
birthday	`b3:Td{I
biscuit	`bIsk@t
bisect	bAe`sekt
bisexual	bAe`sekS}:@l
bishop	`bIS@p
bistro	`bIstr\@}
bit	bIt
bitch	bItS
bite	bAet
bitter	`bIt@
bitumen	`bItS@m@n
bivouac	`bIv}:{k
bizarre	b@`z6:
blab	bl{b
black	bl{k
blackboard	`bl{kbo:d
blackhead	`bl{khed
blackmail	`bl{km{Il
blackout	`bl{k{Ot
blacksmith	`bl{ksmIT
bladder	`bl{d@
blade	bl{Id
blame	bl{Im
bland	bl{nd
blank	bl{Nk
blanket	`bl{Nk@t
blare	ble:
blaspheme	bl{s`fi:m
blast	bl6:st
blatant	`bl{It@nt
blaze	bl{Iz
blazer	`bl{Iz@
bleach	bli:tS
bleak	bli:k
bleary	`blI@r\i:
bleat	bli:t
bleed	bli:d
blemish	`blemIS
blend	blend
blender	`blend@
bless	bles
blessing	`blesIN
blew	bl}:
blight	blAet
blind	blAend
blindfold	`blAendf@}ld
blink	blINk
blinker	`blINk@
bliss	blIs
blister	`blIst@
blistering	`blIst@r\IN
blitz	blIts
blizzard	`blIz@d
bloated	`bl@}t@d
bloc	blOk
block	blOk
blockade	blO`k{Id
blockbuster	`blOkb6st@
bloke	bl@}k
blond	blOnd
blonde	blOnd
blood	bl6d
bloodbath	`bl6db6:T
bloodshed	`bl6dSed
bloodshot	`bl6dSOt
bloodstream	`bl6dstr\i:m
bloodthirsty	`bl6dT3:sti:
bloody	`bl6di:
bloody-minded	bl6di:`mAend@d
bloom	bl}:m
blossom	`blOs@m
blot	blOt
blouse	bl{Oz
blow	bl@}
blowout	`bl@}{Ot
blowtorch	`bl@}to:tS
blubber	`bl6b@
bludge	bl6dZ
bludgeon	`bl6dZ@n
blue	bl}:
blue-collar	`bl}:kOl@
bluebird	bl}:b3:d
bluebottle	`bl}:bOt@l
blueprint	`bl}:pr\Int
blues	bl}:z
bluff	bl6f
blunder	`bl6nd@
blunt	bl6nt
blur	bl3:
blurb	bl3:b
blurt	bl3:t
blush	bl6S
bluster	`bl6st@
BMX	bi:em`eks
board	bo:d
boarder	`bo:d@
boast	b@}st
boat	b@}t
bob	bOb
bobbin	`bOb@n
bodice	`bOd@s
body	`bOdi:
bodyguard	`bOdi:g6:d
bog	bOg
bogus	`b@}g@s
bogy	`b@}gi:
boil	boIl
boiler	`boIl@
boilersuit	`boIl@s}:t
boisterous	`boIstr\@s
bold	b@}ld
bolster	`b@}lst@
bolt	b@}lt
bomb	bOm
bombard	bOm`b6:d
bombshell	`bOmSel
bond	bOnd
bone	b@}n
bonfire	`bOnfAe@
bongo	`bONg@}
bonnet	`bOn@t
bonus	`b@}n@s
boob	b}:b
boobook	`b}:bUk
book	bUk
bookcase	`bUkk{Is
bookkeeping	`bUkki:pIN
bookmaker	`bUkm{Ik@
bookstall	`bUksto:l
bookworm	`bUkw3:m
boom	b}:m
boomer	`b}:m@
boomerang	`b}:m@r\{N
boon	b}:n
boor	bo:
boost	b}:st
boot	b}:t
booth	b}:D
boots	b}:ts
booty	`b}:ti:
booze	b}:z
border	`bo:d@
borderline	`bo:d@lAen
bore	bo:
born	bo:n
borne	bo:n
boronia	b@`r\@}ni:@
borough	`b6r\@
borrow	`bOr\@}
bosom	`bUz@m
boss	bOs
botanist	`bOt@n@st
botch	bOtS
both	b@}T
bother	`bOD@
bottle	`bOt@l
bottlebrush	`bOt@lbr\6S
bottleneck	`bOt@lnek
bottom	`bOt@m
bough	b{O
bought	bo:t
boulder	`b@}ld@
boulevard	`b}:l@v6:d
bounce	b{Ons
bouncing	`b{OnsIN
bouncy	`b{Onsi:
bound	b{Ond
boundary	`b{Ondr\i:
bounty	`b{Onti:
bouquet	b}:`k{I
bourgeois	`bU@Zw6:
bout	b{Ot
boutique	b}:`ti:k
bow	b@}
bowel	`b{O@l
bowerbird	`b{O@b3:d
bowl	b@}l
bowling	`b@}lIN
bowls	b@}lz
bowser	`b{Oz@
box	bOks
boxer	`bOks@
boy	boI
boycott	`boIkOt
Boyd	boId
boyfriend	`boIfr\end
bra	br\6:
brace	br\{Is
bracelet	`br\{Isl@t
bracken	`br\{k@n
bracket	`br\{k@t
brag	br\{g
braid	br\{Id
braille	br\{Il
brain	br\{In
brainstorm	`br\{Insto:m
brainwash	`br\{InwOS
brainwave	`br\{Inw{Iv
braise	br\{Iz
brake	br\{Ik
bran	br\{n
branch	br\{ntS
brand	br\{nd
brash	br\{S
brass	br\6:s
brassiere	`br\{zi:@
brat	br\{t
bravado	br\@`v6:d@}
brave	br\{Iv
brawl	br\o:l
brawn	br\o:n
brazen	`br\{Iz@n
breach	br\i:tS
bread	br\ed
bread-and-butter	br\ed@n`b6t@
breadline	`br\edlAen
breadth	br\edT
breadwinner	`br\edwIn@
break	br\{Ik
break-in	`br\{IkIn
breakable	`br\{Ik@b@l
breakdown	`br\{Ikd{On
breakfast	`br\ekf@st
breakthrough	`br\{IkTr\}:
bream	br\Im
breast	br\est
breaststroke	`br\eststr\@}k
breath	br\eT
breathalyser	`br\eT@lAez@
breathe	br\i:D
breathtaking	`br\eTt{IkIN
breed	br\i:d
breeze	br\i:z
breezy	`br\i:zi:
brevity	`br\ev@ti:
brew	br\}:
brewery	`br\}:@r\i:
bribe	br\Aeb
brick	br\Ik
brick-veneer	br\Ikv@`nI@
brickie	`br\Iki:
bricklayer	`br\Ikl{I@
bride	br\Aed
bridegroom	`br\Aedgr\}:m
bridesmaid	`br\Aedzm{Id
bridge	br\IdZ
bridle	`br\Aed@l
brief	br\i:f
briefcase	`br\i:fk{Is
bright	br\Aet
brilliant	`br\Ilj@nt
brim	br\Im
brine	br\Aen
bring	br\IN
brink	br\INk
brisk	br\Isk
bristle	`br\Is@l
brittle	`br\It@l
broach	br\@}tS
broad	br\o:d
broad-minded	br\o:d`mAend@d
broadcast	`br\o:dk6:st
broccoli	`br\Ok@li:
brochure	`br\@}S@
broke	br\@}k
broken	`br\@}k@n
broker	`br\@}k@
brolga	`br\Olg@
brolly	`br\Oli:
bronchitis	br\ON`kAet@s
bronze	br\Onz
brooch	br\@}tS
brood	br\}:d
broom	br\}:m
bros.	`br\6D@z
broth	br\OT
brothel	`br\OT@l
brother	`br\6D@
brother-in-law	`br\6D@r\Inlo:
brought	br\o:t
brow	br\{O
browbeat	`br\{Obi:t
brown	br\{On
browse	br\{Oz
bruise	br\}:z
brumby	`br\6mbi:
brunch	br\6ntS
brunette	br\}:`net
brunt	br\6nt
brush	br\6S
brutal	`br\}:t@l
brute	br\}:t
bubble	`b6b@l
bubbler	`b6bl@
buck	b6k
bucket	`b6k@t
buckle	`b6k@l
bucktooth	b6k`t}:T
bud	b6d
Buddhism	`bUdIz@m
buddy	`b6di:
budge	b6dZ
budgerigar	`b6dZ@r\i:g6:
budget	`b6dZ@t
budgie	`b6dZi:
buff	b6f
buffer	`b6f@
buffet	`b6f{I
buffoon	b@`f}:n
bug	b6g
bugbear	`b6gbe:
bugger	`b6g@
bugle	`bj}:g@l
build	bIld
building	`bIldIN
bulb	b6lb
bulge	b6ldZ
bulk	b6lk
bull	bUl
bullbar	`bUlb6:
bulldog	bUldOg
bulldozer	`bUld@}z@
bullet	`bUl@t
bulletin	`bUl@t@n
bullion	`bUlj@n
bullock	`bUl@k
bullseye	`bUlzAe
bullshit	`bUlSIt
bully	`bUli:
bum	b6m
bumble	`b6mb@l
bump	b6mp
bumper	`b6mp@
bun	b6n
bunch	b6ntS
bundle	`b6nd@l
bundy	`b6ndi:
bung	b6N
bungalow	`b6Ng@l@}
bungle	`b6Ng@l
bunion	`b6nj@n
bunk	b6Nk
bunker	`b6Nk@
bunny	`b6ni:
bunyip	`b6nj@p
buoy	boI
buoyant	`boI@nt
burble	`b3:b@l
burden	`b3:d@n
bureau	`bj}:r\@}
bureaucracy	bj}:`r\Okr\@si:
bureaucrat	`bj}:r\@kr\{t
burglar	`b3:gl@
burial	`ber\i:@l
burl	b3:l
burly	`b3:li:
burn	b3:n
burnish	`b3:nIS
burp	b3:p
burr	b3:
burrow	`b6r\@}
bursar	`b3:s@
bursary	`b3:s@r\i:
burst	b3:st
bury	`ber\i:
bus	b6s
bush	bUS
bushed	bUSt
bushfire	`bUSfAe@
bushie	`bUSi:
bushman	`bUSm@n
bushranger	`bUSr\{IndZ@
bushwalk	`bUSwo:k
bushwhacker	`bUSw{k@
business	`bIzn@s
businesslike	`bIzn@slAek
busker	`b6sk@
bust	b6st
bustard	`b6st@d
bustle	`b6s@l
busy	`bIzi:
busybody	`bIzi:bOdi:
but	b6t
butane	`bj}:t{In
butch	bUtS
butcher	`bUtS@
butcherbird	`bUtS@b3:d
butler	b6tl@
butt	b6t
butter	`b6t@
buttocks	`b6t@ks
button	`b6t@n
buttress	`b6tr\@s
buy	bAe
buying	bAeIN
buzz	b6z
by	bAe
by-election	`bAe@lekS@n
by-law	`bAelo:
by-product	`bAepr\Od6kt
bye	bAe
BYO	bi:wAe`@}
bypass	`bAep6:s
bystander	`bAest{nd@
byte	bAet
byword	`bAew3:d
C	si:
c	si:
c/o	`ke:r\Ov
cab	k{b
cabbage	`k{bIdZ
cabin	`k{b@n
cabinet	`k{b@n@t
cable	`k{Ib@l
cackle	`k{k@l
cadet	k@`det
cadge	k{dZ
cafe	`k{f{I
caf√©	k{f{I
cafeteria	k{f@`tI@r\i:@
cage	k{IdZ
cagey	`k{IdZi:
cake	k{Ik
calamari	k{l@`m6:r\i:
calamity	k@`l{m@ti:
calcium	`k{lsi:@m
calculate	`k{lkj@l{It
calculating	`k{lkj@l{ItIN
calculator	`k{lkj@l{It@
calendar	`k{l@nd@
calf	k6:f
call	ko:l
callgirl	`ko:lg3:l
callous	`k{l@s
calm	k6:m
calorie	`k{l@r\i:
came	k{Im
camel	k{m@l
camera	`k{mr\@
camouflage	`k{m@fl6:Z
camp	k{mp
campaign	k{m`p{In
campus	`k{mp@s
can	k{n
canal	k@`n{l
cancel	`k{ns@l
cancer	`k{ns@
candid	`k{nd@d
candidate	`k{nd@d{It
candle	`k{nd@l
candour	`k{nd@
cane	k{In
canine	`k{InAen
cannabis	`k{n@b@s
cannon	`k{n@n
cannot	`k{nOt
canoe	k@`n}:
canopy	`k{n@pi:
cant	k6:nt
canteen	k{n`ti:n
canter	`k{nt@
Cantonese	k{nt@`ni:z
canvas	`k{nv@s
canyon	`k{nj@n
cap	k{p
capable	`k{Ip@b@l
capacity	k@`p{s@ti:
cape	k{Ip
capital	`k{p@t@l
capitalise	`k{p@t@lAez
capitalism	`k{p@t@lIz@m
capsicum	`k{ps@k@m
capsize	k{p`sAez
capsule	`k{pS}:l
captain	`k{pt@n
caption	`k{pS@n
captivate	`k{pt@v{It
captive	`k{ptIv
captivity	k{p`tIv@ti:
capture	`k{ptS@
car	k6:
carafe	k@`r\6:f
caramel	`k{r\@m@l
carat	`k{r\@t
caravan	`k{r\@v{n
carbohydrate	k6:b@`hAedr\{It
carbon	`k6:b@n
carburettor	k6:bj@`r\et@
carcass	`k6:k@s
carcinogen	k6:`sIn@dZ@n
card	k6:d
cardboard	`k6:dbo:d
cardiac	`k6:di:{k
cardigan	`k6:dIg@n
care	ke:
career	k@`r\I@
careful	`ke:f@l
careless	`ke:l@s
caress	k@`r\es
caretaker	`ke:t{Ik@
cargo	`k6:g@}
caricature	`k{r\@k@tSU@
carnage	`k6:nIdZ
carnival	`k6:n@v@l
carol	`k{r\@l
carpenter	`k6:p@nt@
carpet	`k6:p@t
carriage	`k{r\IdZ
carry	`k{r\i:
cart	k6:t
cartilage	`k6:t@lIdZ
carton	`k6:t@n
cartoon	k6:`t}:n
cartridge	`k6:tr\IdZ
carts	k6:ts
carve	k6:v
case	k{Is
cash	k{S
cashier	k{`SI@
casino	k@`si:n@}
cask	k6:sk
casserole	`k{s@r\@}l
cassette	k@`set
cast	k6:st
caste	k6:st
castle	`k6:s@l
castor	`k6:st@
castrate	`k{str\{It
casual	`k{Z}:@l
casualty	`k{Z}:@lti:
casuarina	k{Zj@`r\i:n@
cat	k{t
catalogue	`k{t@lOg
catapult	`k{t@p6lt
cataract	`k{t@r\{kt
catarrh	k@`t6:
catastrophe	k@`t{str\@fi:
catch	k{tS
category	`k{t@g@r\i:
cater	`k{It@
caterpillar	k{t@pIl@
cathedral	k@`Ti:dr\@l
cattle	`k{t@l
caucus	`ko:k@s
caught	ko:t
cauliflower	`kOli:fl{O@
cause	ko:z
caused	ko:zd
causeway	`ko:zw{I
caustic	`kOstIk
cauterise	`ko:t@r\Aez
cautious	`ko:S@s
cavalry	`k{v@lr\i:
cave	k{Iv
cavern	`k{v@n
cavity	`k{v@ti:
CD	si:`di:
cease	si:s
ceasefire	`si:sfAe@
ceiling	`si:lIN
celebrate	`sel@br\{It
celebrated	`sel@br\{It@d
celebrity	s@`lebr\@ti:
celery	`sel@r\i:
celibacy	`sel@b@si:
cell	sel
cellar	`sel@
Celsius	`selsi:@s
cement	s@`ment
cemetery	`sem@tr\i:
censor	`sens@
censure	`senS@
census	`sens@s
cent	sent
centenary	sen`ten@r\i:
centigrade	`sent@gr\{Id
centimetre	`sent@mi:t@
central	`sentr\@l
centre	`sent@
century	`sentS@r\i:
ceramic	s@`r\{mIk
cereal	`sI@r\i:@l
cerebral	`ser\@br\@l
ceremony	`ser\@m@ni:
certain	`s3:t@n
certainly	`s3:t@nli:
certificate	s@`tIf@k@t
certify	`s3:t@fAe
cervix	`s3:vIks
CES	si:i:`es
chafe	tS{If
chain	tS{In
chainsaw	`tS{Inso:
chair	tSe:
chairman	`tSe:m@n
chairperson	`tSe:p3:s@n
chalk	tSo:k
challenge	`tS{l@ndZ
chamber	`tS{Imb@
chamois	`S{mi:
champion	`tS{mpi:@n
chance	tS{ns
change	tS{IndZ
changing	tS{IndZIN
channel	`tS{n@l
chant	tS{nt
chaos	`k{IOs
chap	tS{p
chapel	`tS{p@l
chapped	tS{pt
chapter	`tS{pt@
character	`k{r\@kt@
characteristic	k{r\@kt@`r\IstIk
charade	S@`r\6:d
charcoal	`tS6:k@}l
charge	tS6:dZ
charisma	k@`r\Izm@
charity	`tS{r\@ti:
Charles	tS6:lz
charm	tS6:m
chart	tS6:t
charter	`tS6:t@
chase	tS{Is
chassis	`S{zi:
chat	tS{t
chatter	`tS{t@
chauffeur	`S@}f@
chauvinism	`S@}v@nIz@m
cheap	tSi:p
cheat	tSi:t
check	tSek
check-up	`tSek6p
checkout	`tSek{Ot
cheek	tSi:k
cheer	tSI@
cheerful	`tSI@fUl
cheese	tSi:z
chef	Sef
chemical	`kemIk@l
chemist	`kem@st
chemistry	`kem@str\i:
chemotherapy	ki:m@}`Ter\@pi:
cheque	tSek
chequebook	`tSekbUk
cherish	`tSer\IS
cherub	`tSer\@b
chess	tSes
chest	tSest
chew	tS}:
chic	Si:k
chick	tSIk
chicken	`tSIk@n
chickenpox	`tSIk@npOks
chief	tSi:f
child	tSAeld
childish	`tSAeldIS
children	tSIldr\@n
chill	tSIl
chilli	`tSIli:
chime	tSAem
chimney	`tSImni:
chin	tSIn
china	`tSAen@
Chinese	`tSAeni:z
chip	tSIp
chipboard	`tSIpbo:d
chiropractor	`kAer\@pr\{kt@
chirp	tS3:p
chirpy	`tS3:pi:
chisel	`tSIz@l
chlorine	`klo:r\i:n
chocolate	`tSOkl@t
choice	tSoIs
choir	`kwAe@
choke	tS@}k
cholera	`kOl@r\@
cholesterol	k@`lest@r\Ol
chook	tSUk
choose	tS}:z
chop	tSOp
choppy	`tSOpi:
chopsticks	`tSOpstIks
chord	ko:d
chore	tSo:
choreographer	kOr\i:`Ogr\@f@
chorus	`ko:r\@s
chose	tS@}z
chosen	`tS@}z@n
chows	tS{Oz
christen	`kr\Is@n
Christianity	kr\IstSi:`{n@ti:
Christmas	`kr\Ism@s
chrome	kr\@}m
chronic	`kr\OnIk
chronological	kr\On@`lOdZIk@l
chubby	`tS6bi:
chuck	tS6k
chuckle	`tS6k@l
chunder	`tS6nd@
chunk	tS6Nk
church	tS3:tS
churn	tS3:n
chute	S}:t
chutney	`tS6tni:
cider	`sAed@
cigar	s@`g6:
cigarette	sIg@`r\et
cinema	`sIn@m@
circle	`s3:k@l
circled	s3:k@ld
circuit	`s3:k@t
circulate	`s3:kj@l{It
circulation	s3:kj@`l{IS@n
circumcise	`s3:k@msAez
circumference	s@`k6mf@r\@ns
circumstance	`s3:k@mst{ns
circus	`s3:k@s
citizen	`sIt@z@n
citrus	`sItr\@s
city	`sIti:
civic	`sIvIk
civil	`sIv@l
civilian	s@`vIlj@n
civilisation	sIv@lAe`z{IS@n
civilised	`sIv@lAezd
Cl.	kl@}s
claim	kl{Im
clairvoyant	kle:`voI@nt
clam	kl{m
clamber	`kl{mb@
clammy	`kl{mi:
clamour	`kl{m@
clamp	kl{mp
clan	kl{n
clandestine	`kl{nd@stAen
clang	kl{N
clanger	`kl{N@
clap	kl{p
clarify	`kl{r\@fAe
clarity	`kl{r\@ti:
clark	kl6:k
clash	kl{S
clasp	kl{sp
class	kl6:s
classic	`kl{sIk
classify	`kl{s@fAe
classroom	`kl6:sr\}:m
clatter	`kl{t@
clause	klo:z
claustrophobia	klOstr\@`f@}bi:@
claw	klo:
clay	kl{I
clean	kli:n
cleaning	kli:nIN
clear	klI@
clearance	`klI@r\@ns
clearing	`klI@r\IN
clearway	`klI@w{I
clench	klentS
clergy	`kl3:dZi:
clerk	kl6:k
clever	`klev@
cliche	`kli:S{I
click	klIk
client	`klAe@nt
cliff	klIf
climate	`klAem@t
climax	`klAem{ks
climb	klAem
clinch	klIntS
cling	klIN
clinic	`klInIk
clip	klIp
cloak	kl@}k
clock	klOk
clockwise	`klOkwAez
clockwork	`klOkw3:k
clog	klOg
clone	kl@}n
close	kl@}z
close-up	`kl@}s6p
closet	klOz@t
clot	klOt
cloth	klOT
clothe	kl@}D
clothes	kl@}Dz
clothing	`kl@}DIN
cloud	kl{Od
cloudy	`kl{Odi:
clout	kl{Ot
clover	`kl@}v@
clown	kl{On
club	kl6b
clucky	`kl6ki:
clue	kl}:
clump	kl6mp
clumsy	`kl6mzi:
clung	kl6N
cluster	`kl6st@
clutch	kl6tS
clutter	`kl6t@
cm	`sent@mi:t@
Co	`k6mp@ni:
coach	k@}tS
coagulate	k@}`{gj@l{It
coal	k@}l
coalition	k@}@`lIS@n
coarse	ko:s
coast	k@}st
coastline	`k@}stlAen
coat	k@}t
coathanger	`k@}th{N@
coating	`k@}tIN
coax	k@}ks
cobblestone	kOb@lst@}n
cobweb	`kObweb
cobwebs	kObwebz
cocaine	k@}`k{In
cock	kOk
cock-up	`kOk6p
cockatoo	kOk@`t}:
cockpit	`kOkpIt
cocktail	`kOkt{Il
cocky	`kOki:
cocoa	`k@}k@}
coconut	`k@}k@n6t
COD	si:@}`di:
code	k@}d
codeine	`k@}di:n
coerce	k@}`3:s
coffee	`kOfi:
coffin	`kOf@n
cog	kOg
coherent	k@}`hI@r\@nt
cohesion	k@}`hi:Z@n
coil	koIl
coin	koIn
coincide	k@}@n`sAed
coincidence	k@}`Ins@d@ns
coke	k@}k
Col	kOl
colander	`kOl@nd@
cold	k@}ld
cold-blooded	`k@}ldbl6d@d
coleslaw	`k@}lslo:
colic	`kOlIk
collaborate	k@`l{b@r\{It
collapse	k@`l{ps
collar	`kOl@
collarbone	`kOl@b@}n
collateral	k@`l{t@r\@l
colleague	`kOli:g
collect	k@`lekt
collective	k@`lektIv
collector	k@`lekt@
college	`kOlIdZ
collide	k@`lAed
cologne	k@`l@}n
colon	`k@}l@n
colonel	`k3:n@l
colony	`kOl@ni:
colossal	k@`lOs@l
colour	`k6l@
colt	k@}lt
column	`kOl@m
coma	`k@}m@
comb	k@}m
combat	`kOmb{t
combination	kOmb@`n{IS@n
combine	k@m`bAen
come	k6m
comedy	`kOm@di:
comet	`kOm@t
comfort	`k6mf@t
comfortable	`k6mft@b@l
comic	`kOmIk
comma	`kOm@
command	k@`m{nd
commando	k@`m{nd@}
commemorate	k@`mem@r\{It
commence	k@`mens
commend	k@`mend
comment	`kOment
commentary	`kOm@ntr\i:
commerce	`kOm3:s
commercial	k@`m3:S@l
commiserate	k@`mIz@r\{It
commission	k@`mIS@n
commissioner	k@`mIS@n@
commit	k@`mIt
commitment	k@`mItm@nt
committee	k@`mIti:
commodity	k@`mOd@ti:
common	`kOm@n
Commonwealth	`kOm@nwelT
commotion	k@`m@}S@n
communal	k@`mj}:n@l
commune	`kOmj}:n
communicate	k@`mj}:n@k{It
communication	k@`mj}:n@k{IS@n
communism	`kOmj@nIz@m
community	k@`mj}:n@ti:
commute	k@`mj}:t
compact	`kOmp{kt
companion	k@m`p{nj@n
company	`k6mp@ni:
comparative	k@m`p{r\@tIv
compare	k@m`pe:
comparison	k@m`p{r\@s@n
compartment	k@m`p6:tm@nt
compass	`k6mp@s
compassion	k@m`p{S@n
compatible	k@m`p{t@b@l
compel	k@m`pel
compelling	k@m`pelIN
compensate	`kOmp@ns{It
compere	`kOmpe:
compete	k@m`pi:t
competent	`kOmp@t@nt
competition	kOmp@`tIS@n
competitive	k@m`pet@tIv
compile	k@m`pAel
complacent	k@m`pl{Is@nt
complain	k@m`pl{In
complaint	k@m`pl{Int
complement	`kOmpl@m@nt
complete	k@m`pli:t
complex	`kOmpleks
complexion	k@m`plekS@n
complicated	`kOmpl@k{It@d
compliment	`kOmpl@m@nt
complimentary	kOmpl@`mentr\i:
comply	k@m`plAe
component	k@m`p@}n@nt
compose	k@m`p@}z
compost	`kOmpOst
compound	`kOmp{Ond
comprehend	kOmpr\@`hend
compress	k@m`pr\es
comprise	k@m`pr\Aez
compromise	`kOmpr\@mAez
compulsion	k@m`p6lS@n
compulsory	k@m`p6ls@r\i:
compute	k@m`pj}:t
computer	k@m`pj}:t@
comrade	`kOmr\{Id
con	kOn
concave	`kOnk{Iv
conceal	k@n`si:l
concede	k@n`si:d
conceit	k@n`si:t
conceited	k@n`si:t@d
conceivable	k@n`si:v@b@l
conceive	k@n`si:v
concentrate	`kOns@ntr\{It
concept	`kOnsept
conception	k@n`sepS@n
concern	k@n`s3:n
concerning	k@n`s3:nIN
concert	`kOns@t
concession	k@n`seS@n
conciliation	k@nsIli:`{IS@n
concise	k@n`sAes
conclude	k@N`kl}:d
concrete	`kONkr\i:t
concur	k@N`k3:
concurrent	k@N`k6r\@nt
concussion	k@N`k6S@n
condemn	k@n`dem
condensation	kOnd@n`s{IS@n
condense	k@n`dens
condescend	kOnd@`send
condition	k@n`dIS@n
conditioned	k@n`dIS@nd
condom	`kOndOm
condone	k@n`d@}n
conduct	k@n`d6kt
cone	k@}n
confectionery	k@n`fekS@nr\i:
confer	k@n`f3:
conference	kOnfr\@ns
confess	k@n`fes
confide	k@n`fAed
confidence	`kOnf@d@ns
confident	`kOnf@d@nt
confidential	kOnf@`denS@l
confine	k@n`fAen
confirm	k@n`f3:m
confiscate	`kOnf@sk{It
conflict	`kOnflIkt
conform	k@n`fo:m
confront	k@n`fr\6nt
confuse	k@n`fj}:z
congested	k@n`dZest@d
congratulate	k@n`gr\{tS@l{It
congregate	`kONgr\@g{It
congregation	kONgr\@`g{IS@n
congress	`kONgr\es
conjunction	k@n`dZ6NkS@n
conjunctivitis	k@ndZ6Nkt@`vAet@s
conjure	`k6ndZ@
connect	k@`nekt
conquer	`kONk@
conscience	`kOnS@ns
conscientious	kOnSi:`enS@s
conscious	`kOnS@s
conscript	`kOnskr\Ipt
consecutive	k@n`sekj@tIv
consent	k@n`sent
consequence	`kOns@kw@ns
conservation	kOns@`v{IS@n
conservative	k@n`s3:v@tIv
conserve	k@n`s3:v
consider	k@n`sId@
considerable	k@n`sIdr\@b@l
considerate	k@n`sId@r\@t
consideration	k@nsId@`r\{IS@n
considered	k@nsId@d
consist	k@n`sIst
consistency	k@n`sIst@nsi:
consistent	k@n`sIst@nt
consolation	kOns@`l{IS@n
console	k@n`s@}l
consonant	`kOns@n@nt
conspicuous	k@n`spIkj}:@s
conspiracy	k@n`spIr\@si:
constable	`k6nst@b@l
constant	`kOnst@nt
constellation	kOnst@`l{IS@n
consternation	kOnst@`n{IS@n
constipation	kOnst@`p{IS@n
constituency	k@n`stItj}:@nsi:
constitution	kOnst@`tj}:S@n
constrict	k@n`str\Ikt
construct	k@n`str\6kt
constructive	k@n`str\6ktIv
consul	`kOns@l
consult	k@n`s6lt
consultant	k@n`s6lt@nt
consume	k@n`sj}:m
consumer	k@n`sj}:m@
contact	`kOnt{kt
contagious	k@n`t{IdZ@s
contain	k@n`t{In
container	k@n`t{In@
contaminate	k@n`t{m@n{It
contemplate	`kOnt@mpl{It
contemporary	k@n`temp@r\i:
contempt	k@n`tempt
contend	k@n`tend
content	`kOntent
contest	`kOntest
context	`kOntekst
continent	`kOnt@n@nt
continual	k@n`tInj}:@l
continue	k@n`tInj}:
continuous	k@n`tInj}:@s
contour	`kOntU@
contraband	`kOntr\@b{nd
contraception	kOntr\@`sepS@n
contraceptive	kOntr\@`septIv
contract	`kOntr\{kt
contradict	kOntr\@`dIkt
contrary	`kOntr\e:r\i:
contrast	`kOntr\6:st
contribute	k@n`tr\Ibj}:t
control	k@n`tr\@}l
controversy	`kOntr\@v3:si:
convalescence	kOnv@`les@ns
convene	k@n`vi:n
convenience	k@n`vi:ni:@ns
convenient	k@n`vi:ni:@nt
convent	`kOnv@nt
convention	k@n`venS@n
conventional	k@n`venS@n@l
conversation	kOnv@`s{IS@n
converse	`kOnv3:s
convert	k@n`v3:t
convertible	k@n`v3:t@b@l
convex	`kOnveks
convey	k@n`v{I
convict	k@n`vIkt
conviction	k@n`vIkS@n
convince	k@n`vIns
convoy	`kOnvoI
cook	kUk
cool	k}:l
coolabah	`k}:l@b6:
coop	k}:p
cooperate	k@}`Op@r\{It
coordinate	k@}`o:d@n{It
cop	kOp
cope	k@}p
copper	`kOp@
copy	`kOpi:
copyright	`kOpi:r\Aet
coral	`kOr\@l
cord	ko:d
cordial	`ko:di:@l
corduroy	`ko:d@r\oI
core	ko:
cork	ko:k
corkscrew	`ko:kskr\}:
corn	ko:n
corner	`ko:n@
cornflakes	`ko:nfl{Iks
corny	`ko:ni:
coronary	`kOr\@nr\i:
coronation	kOr\@`n{IS@n
coroner	`kOr\@n@
corporal	`ko:pr\@l
corporation	ko:p@`r\{IS@n
corps	ko:
corpse	ko:ps
correct	k@`r\ekt
correspond	kOr\@`spOnd
corridor	`kOr\@do:
corroboree	k@`r\Ob@r\i:
corrode	k@`r\@}d
corrugated	`kOr\@g{It@d
corrupt	k@`r\6pt
cortisone	`ko:t@z@}n
cosmetic	kOz`metIk
cosmopolitan	kOzm@`pOl@t@n
cosmos	`kOzmOs
cossie	`kOzi:
cost	kOst
costume	`kOstj}:m
cosy	`k@}zi:
cot	kOt
cottage	`kOtIdZ
cotton	`kOt@n
couch	k{OtS
cough	kOf
could	kUd
couldn't	kUd@nt
council	`k{Ons@l
counsel	`k{Ons@l
count	k{Ont
counter	`k{Ont@
counterfeit	`k{Ont@fIt
country	`k6ntr\i:
coup	k}:
couple	`k6p@l
coupon	`k}:pOn
courage	`k6r\IdZ
courier	`kUr\i:@
course	ko:s
court	ko:t
courteous	`k3:ti:@s
courtyard	`ko:tj6:d
cousin	`k6z@n
cove	k@}v
covenant	`k6v@n@nt
cover	`k6v@
covet	`k6v@t
cow	k{O
coward	`k{O@d
coyote	kAe@}ti:
crab	kr\{b
crack	kr\{k
cracker	`kr\{k@
crackle	`kr\{k@l
crackling	`kr\{klIN
cradle	`kr\{Id@l
craft	kr\6:ft
crafty	`kr\6:fti:
crag	kr\{g
cram	kr\{m
cramp	kr\{mp
cramped	kr\{mpt
crane	kr\{In
crank	kr\{Nk
cranky	`kr\{Nki:
cranny	kr\{ni:
crash	kr\{S
crate	kr\{It
crater	`kr\{It@
crave	kr\{Iv
crawl	kr\o:l
crayfish	`kr\{IfIS
crayon	`kr\{IOn
craze	kr\{Iz
crazy	`kr\{Izi:
creak	kr\i:k
cream	kr\i:m
crease	kr\i:s
create	kr\i:`{It
creature	`kr\i:tS@
creche	kr\{IS
credible	`kr\ed@b@l
credit	`kr\ed@t
creek	kr\i:k
creep	kr\i:p
creeper	`kr\i:p@
cremate	kr\@`m{It
crematorium	kr\em@`to:r\i:@m
crepe	kr\{Ip
crest	kr\est
crevice	`kr\ev@s
crew	kr\}:
crib	kr\Ib
cricket	`kr\Ik@t
crime	kr\Aem
crimson	`kr\Imz@n
cringe	kr\IndZ
crinkle	`kr\INk@l
cripple	`kr\Ip@l
crisis	`kr\Aes@s
crisp	kr\Isp
critic	`kr\ItIk
critical	`kr\ItIk@l
croak	kr\@}k
Croatian	kr\@}`{IS@n
crockery	`kr\Ok@r\i:
crocodile	`kr\Ok@dAel
crook	kr\Uk
crooked	`kr\Uk@d
croon	kr\}:n
crop	kr\Op
Cross	kr\Os
cross	kr\Os
cross-examine	kr\Oseg`z{m@n
crossroads	`kr\Osr\@}dz
crossword	`kr\Osw3:d
crouch	kr\{OtS
croupier	`kr\}:pi:@
crow	kr\@}
crowbar	`kr\@}b6:
crowd	kr\{Od
crown	kr\{On
crucial	`kr\}:S@l
crucify	`kr\}:s@fAe
crude	kr\}:d
cruel	`kr\}:@l
cruise	kr\}:z
crumb	kr\6m
crumble	`kr\6mb@l
crummy	`kr\6mi:
crumpet	`kr\6mp@t
crumple	`kr\6mp@l
crunch	kr\6ntS
crusade	kr\}:`s{Id
crush	kr\6S
crust	kr\6st
crustacean	kr\6s`t{IS@n
crutch	kr\6tS
crux	kr\6ks
cry	kr\Ae
cryptic	`kr\IptIk
crystal	`kr\Ist@l
cub	k6b
cube	kj}:b
cubic	`kj}:bIk
cubicle	`kj}:bIk@l
cucumber	`kj}:k6mb@
cuddle	`k6d@l
cuddly	`k6dli:
cue	kj}:
cuff	k6f
cul-de-sac	`k6ld@s{k
culinary	`k6l@nr\i:
culminate	`k6lm@n{It
culprit	`k6lpr\@t
cult	k6lt
cultivate	`k6lt@v{It
culture	`k6ltS@
cumbersome	`k6mb@s@m
cumquat	`k6mkwOt
cunning	`k6nIN
cunt	k6nt
cup	k6p
cupboard	`k6b@d
curb	k3:b
curdle	`k3:d@l
cure	`kj}:@
curious	`kj}:r\i:@s
curl	k3:l
currant	`k6r\@nt
currawong	`k6r\@wON
currency	`k6r\@nsi:
current	`k6r\@nt
curriculum	k@`r\Ikj@l@m
curry	`k6r\i:
curse	k3:s
curt	k3:t
curtail	k3:`t{Il
curtain	`k3:t@n
curtsy	`k3:tsi:
curve	k3:v
cushion	`kUS@n
cushy	`kUSi:
custard	`k6st@d
custody	`k6st@di:
custom	`k6st@m
customary	`k6st@mr\i:
customer	`k6st@m@
customers	k6st@m@z
cut	k6t
cute	kj}:t
cuticle	`kj}:tIk@l
cutlery	`k6tl@r\i:
cutlet	`k6tl@t
CV	si:`vi:
cycle	`sAek@l
cyclone	`sAekl@}n
cylinder	`sIl@nd@
cynic	`sInIk
cynical	`sInIk@l
cyst	sIst
cystitis	sIs`tAet@s
Czech	tSek
D	di:
d	di:
dab	d{b
dabble	d{b@l
dad	d{d
dagger	`d{g@
daily	`d{Ili:
dainty	`d{Inti:
dairy	`de:r\i:
dais	`d{I@s
dam	d{m
damage	`d{mIdZ
damn	d{m
damned	d{md
damnedest	`d{md@st
damp	d{mp
dampen	`d{mp@n
damper	`d{mp@
dance	d{ns
dandruff	`d{ndr\6f
danger	`d{IndZ@
dangle	`d{Ng@l
dank	d{Nk
dapper	`d{p@
dappled	`d{p@ld
dare	de:
daredevil	`de:dev@l
dark	d6:k
darkroom	`d6:kr\}:m
darling	`d6:lIN
darn	d6:n
dart	d6:t
dash	d{S
dashboard	`d{Sbo:d
data	`d6:t@
database	`d{It@b{Is
date	d{It
dated	`d{It@d
daub	do:b
daughter	`do:t@
daughter-in-law	`do:t@r\Inlo:
daunt	do:nt
dawdle	`do:d@l
dawn	do:n
day	d{I
daybreak	`d{Ibr\{Ik
daydream	`d{Idr\i:m
daylight	`d{IlAet
daytime	`d{ItAem
daze	d{Iz
dazzle	`d{z@l
dead	ded
dead-end	`dedend
deaden	`ded@n
deadline	`dedlAen
deadlock	`dedlOk
deadly	`dedli:
deaf	def
deal	di:l
dealer	`di:l@
dealings	`di:lINz
dear	dI@
death	deT
debatable	d@`b{It@b@l
debate	d@`b{It
debit	`deb@t
debris	`debr\i:
debt	det
debug	di:`b6g
debut	`d{Ibj}:
decade	`dek{Id
decadent	`dek@d@nt
decaffeinated	di:`k{f@n{It@d
decapitate	di:`k{p@t{It
decathlon	d@`k{TlOn
decay	d@`k{I
deceased	d@`si:st
deceitful	d@`si:tfUl
deceive	d@`si:v
December	d@`semb@
decent	`di:s@nt
decentralise	di:`sentr\@lAez
deception	d@`sepS@n
deceptive	d@`septIv
decibel	`des@bel
decide	d@`sAed
decided	d@`sAed@d
deciduous	d@`sIdZ}:@s
decimal	`des@m@l
decimate	`des@m{It
decipher	d@`sAef@
decision	d@`sIZ@n
deck	dek
declare	d@`kle:
decline	d@`klAen
decode	di:`k@}d
decompose	di:k@m`p@}z
decongestant	di:k@n`dZest@nt
decor	`d{Iko:
decorate	`dek@r\{It
decoration	dek@`r\{IS@n
decorum	d@`ko:r\@m
decoy	`di:koI
decrease	d@`kr\i:s
decree	d@`kr\i:
decrepit	d@`kr\ep@t
decry	d@`kr\Ae
dedicate	`ded@k{It
deduce	d@`dj}:s
deduct	d@`d6kt
deduction	d@`d6kS@n
deed	di:d
deep	di:p
deer	dI@
deface	d@`f{Is
defamation	def@`m{IS@n
default	d@`fOlt
defeat	d@`fi:t
defecate	`def@k{It
defect	`di:fekt
defence	d@`fens
defend	d@`fend
defendant	d@`fend@nt
defensive	d@`fensIv
defer	d@`f3:
defiant	d@`fAe@nt
deficient	d@`fIS@nt
deficit	`def@s@t
define	d@`fAen
definite	`def@n@t
definitive	d@`fIn@tIv
deflate	d@`fl{It
deflation	d@`fl{IS@n
deflect	d@`flekt
defoliant	d@`f@}li:@nt
defoliate	d@`f@}li:{It
deform	d@`fo:m
defraud	d@`fr\o:d
defrost	di:`fr\Ost
deft	deft
defunct	d@`f6Nkt
defuse	d@`fj}:z
defy	d@`fAe
degenerate	d@`dZen@r\@t
degradation	degr\@`d{IS@n
degrade	d@`gr\{Id
degree	d@`gr\i:
dehydrate	`di:hAedr\{It
deign	d{In
deity	`d{I@ti:
dejected	d@`dZekt@d
delay	d@`l{I
delectable	d@`lekt@b@l
delegate	`del@g@t
delegation	del@`g{IS@n
delete	d@`li:t
deli	`deli:
deliberate	d@`lIb@r\@t
delicacy	`del@k@si:
delicate	`del@k@t
delicatessen	del@k@`tes@n
delicious	d@`lIS@s
delight	d@`lAet
delinquent	d@`lINkw@nt
delirious	d@`lI@r\i:@s
deliver	d@`lIv@
delta	`delt@
delude	d@`l}:d
deluge	`delj}:dZ
deluxe	d@`l6ks
delve	delv
demand	d@`m{nd
demanding	d@`m{ndIN
demean	d@`mi:n
demeanour	d@`mi:n@
demented	d@`ment@d
dementia	d@`menS@
demerit	di:`mer\@t
demise	d@`mAez
demister	di:`mIst@
demo	`dem@}
democracy	d@`mOkr\@si:
democrat	`dem@kr\{t
Democrats	`dem@kr\{ts
demolish	d@`mOlIS
demon	`di:m@n
demonstrate	`dem@nstr\{It
demonstration	dem@n`str\{IS@n
demonstrative	d@`mOnstr\@tIv
demoralise	d@`mOr\@lAez
demote	di:`m@}t
demure	d@`mjU@
den	den
denigrate	`den@gr\{It
denim	`den@m
denomination	d@`nOm@n{IS@n
denominator	d@`nOm@n{It@
denounce	d@`n{Ons
dense	dens
dent	dent
dental	`dent@l
dentist	`dent@st
denture	`dentS@
deny	d@`nAe
deodorant	di:`@}d@r\@nt
depart	d@`p6:t
departed	d@`p6:t@d
department	d@`p6:tm@nt
depend	d@`pend
dependant	d@`pend@nt
dependent	d@`pend@nt
depict	d@`pIkt
deplete	d@`pli:t
deplore	d@`plo:
deport	d@`po:t
deportment	d@`po:tm@nt
depose	d@`p@}z
deposit	d@`pOz@t
depository	d@`pOz@tr\i:
depot	`dep@}
depraved	d@`pr\{Ivd
depreciate	d@`pr\i:Si:{It
depress	d@`pr\es
depression	d@`pr\eS@n
deprive	d@`pr\Aev
deprived	d@`pr\Aevd
dept	d@`p6:tm@nt
depth	depT
deputation	depj@`t{IS@n
deputy	`depj@ti:
deranged	d@`r\{IndZd
derelict	`der\@lIkt
deride	d@`r\Aed
derivative	d@`r\Iv@tIv
derive	d@`r\Aev
dermatitis	d3:m@`tAet@s
derogatory	d@`r\Og@tr\i:
descend	d@`send
descendant	d@`send@nt
descended	d@`send@d
descent	d@`sent
describe	d@`skr\Aeb
description	d@`skr\IpS@n
desecrate	`des@kr\{It
desert	`dez@t
deserve	d@`z3:v
design	d@`zAen
designate	`dezIgn{It
desirable	d@`zAer\@b@l
desire	d@`zAe@
desk	desk
desktop	`desktOp
desolate	`des@l@t
despair	d@`spe:
desperate	`despr\@t
despicable	d@`spIk@b@l
despise	d@`spAez
despite	d@`spAet
despondent	d@`spOnd@nt
despot	`despOt
dessert	d@`z3:t
destination	dest@`n{IS@n
destined	`dest@nd
destiny	`dest@ni:
destitute	`dest@tj}:t
destroy	d@`str\oI
detach	d@`t{tS
detached	d@`t{tSt
detachment	d@`t{tSm@nt
detail	`di:t{Il
detain	d@`t{In
detect	d@`tekt
detective	d@`tektIv
detention	d@`tenS@n
deter	d@`t3:
detergent	d@`t3:dZ@nt
deteriorate	d@`tI@r\i:@r\{It
determination	d@t3:m@`n{IS@n
determine	d@`t3:m@n
determined	d@`t3:m@nd
determiner	d@`t3:m@n@
deterrent	d@`ter\@nt
detest	d@`test
detonate	`det@n{It
detour	`di:tU@
detract	d@`tr\{kt
detrimental	detr\@`ment@l
devalue	di:`v{lj}:
devastate	`dev@st{It
devastating	`dev@st{ItIN
develop	d@`vel@p
developer	d@`vel@p@
development	d@`vel@pm@nt
deviant	`di:vi:@nt
deviate	`di:vi:{It
device	d@`vAes
devil	`dev@l
devious	`di:vi:@s
devise	d@`vAez
devoid	d@`voId
devote	d@`v@}t
devoted	d@`v@}t@d
devotee	dev@`ti:
devour	d@`v{O@
devout	d@`v{Ot
dew	dj}:
dexterity	deks`ter\@ti:
diabetes	dAe@`bi:ti:z
diabolic	dAe@`bOlIk
diagnose	`dAe@gn@}z
diagonal	dAe`{g@n@l
diagram	`dAe@gr\{m
dial	`dAe@l
dialect	`dAe@lekt
dialogue	`dAe@lOg
diameter	dAe`{m@t@
diametrically	dAe@`metr\Ikli:
diamond	`dAe@m@nd
diaphragm	`dAe@fr\{m
diarrhoea	dAe@`r\I@
diary	`dAe@r\i:
dice	dAes
dicey	`dAesi:
dick	dIk
dickhead	`dIkhed
dictate	dIk`t{It
dictator	dIk`t{It@
diction	`dIkS@n
dictionary	`dIkS@nr\i:
did	dId
didgeridoo	dIdZ@r\i:`d}:
die	dAe
diesel	`di:z@l
diet	`dAe@t
differ	`dIf@
difference	`dIfr\@ns
different	`dIfr\@nt
differentiate	dIf@`r\enSi:{It
difficult	`dIf@k@lt
diffident	`dIf@d@nt
diffuse	d@`fj}:s
dig	dIg
digest	d@`dZest
digger	`dIg@
diggings	`dIgINz
digit	`dIdZ@t
digital	`dIdZ@t@l
dignitary	`dIgn@tr\i:
dignity	`dIgn@ti:
digress	dAe`gr\es
dilapidated	d@`l{p@d{It@d
dilate	dAe`l{It
dilemma	d@`lem@
diligent	`dIl@dZ@nt
dill	dIl
dilute	dAe`l}:t
dim	dIm
dimension	d@`menS@n
diminish	d@`mInIS
dimple	`dImp@l
din	dIn
dine	dAen
diner	`dAen@
ding	dIN
dinghy	`dINgi:
dingo	`dINg@}
dingy	`dIndZi:
dining	`dAenIN
dinki-di	dINki:`dAe
dinkum	`dINk@m
dinner	`dIn@
dinosaur	`dAen@so:
dip	dIp
diphtheria	dIf`TI@r\i:@
diphthong	`dIfTON
diploma	d@`pl@}m@
diplomacy	d@`pl@}m@si:
diplomat	`dIpl@m{t
dire	dAe@
direct	d@`r\ekt
direction	d@`r\ekS@n
directive	d@`r\ektIv
directly	d@`r\ektli:
director	d@`r\ekt@
directory	d@`r\ektr\i:
dirt	d3:t
dirty	`d3:ti:
disability	dIs@`bIl@ti:
disable	dIs`{Ib@l
disadvantage	dIs@d`v{ntIdZ
disadvantaged	dIs@d`v{ntIdZd
disagree	dIs@`gr\i:
disagreeable	dIs@`gr\i:@b@l
disallow	dIs@`l{O
disappear	dIs@`pI@
disappoint	dIs@`poInt
disapprove	dIs@`pr\}:v
disarm	dIs`6:m
disarray	dIs@`r\{I
disaster	d@`z6:st@
disband	dIs`b{nd
disbelieve	dIsb@`li:v
disc	dIsk
discard	dIs`k6:d
discern	d@`s3:n
discerning	d@`s3:nIN
discharge	dIs`tS6:dZ
disciple	d@`sAep@l
disciplinarian	dIs@pl@`ne:r\i:@n
discipline	`dIs@pl@n
disclose	dIs`kl@}z
disco	`dIsk@}
discolour	dIs`k6l@
discomfort	dIs`k6mf@t
disconcert	dIsk@n`s3:t
disconnect	dIsk@`nekt
discontent	dIsk@n`tent
discontinue	dIsk@n`tInj}:
discord	`dIsko:d
discount	`dIsk{Ont
discourage	dIs`k6r\IdZ
discourse	`dIsko:s
discourteous	dIs`k3:ti:@s
discover	d@`sk6v@
discredit	dIs`kr\ed@t
discreet	d@`skr\i:t
discrepancy	d@`skr\ep@nsi:
discrete	d@`skr\i:t
discretion	d@`skr\eS@n
discriminate	d@`skr\Im@n{It
discuss	d@`sk6s
disdain	dIs`d{In
disease	d@`zi:z
disfavour	dIs`f{Iv@
disfigure	dIs`fIg@
disgrace	d@s`gr\{Is
disgruntled	dIs`gr\6nt@ld
disguise	d@s`gAez
disgust	d@s`g6st
dish	dIS
disheartened	dIs`h6:t@nd
dishevelled	dI`Sev@ld
dishonest	dIs`On@st
dishonour	dIs`On@
dishwasher	`dISwOS@
disillusioned	dIs@`l}:Z@nd
disinclined	dIsIn`klAend
disinfect	dIsIn`fekt
disinfectant	dIsIn`fekt@nt
disintegrate	dIs`Int@gr\{It
disinterested	dIs`Intr\@st@d
disjointed	dIs`dZoInt@d
disk	dIsk
diskette	dIs`ket
dislike	dIs`lAek
dislocate	`dIsl@k{It
dislodge	dIs`lOdZ
disloyal	dIs`loI@l
dismal	`dIzm@l
dismantle	dIs`m{nt@l
dismay	dIs`m{I
dismiss	dIs`mIs
dismount	dIs`m{Ont
disobey	dIs@`b{I
disorder	dIs`o:d@
disorganised	dIs`o:g@nAezd
disorientated	dIs`Or\i:@nt{It@d
dispatch	d@`sp{tS
dispel	d@`spel
dispensable	d@`spens@b@l
dispensation	dIspen`s{IS@n
dispense	d@`spens
disperse	d@`sp3:s
displace	dIs`pl{Is
display	d@`spl{I
displease	dIs`pli:z
disposable	d@`sp@}z@b@l
disposal	d@`sp@}z@l
dispose	d@`sp@}z
disposed	d@`sp@}zd
disposition	dIsp@`zIS@n
dispossess	dIsp@`zes
disproportion	dIspr\@`po:S@n
disprove	dIs`pr\}:v
dispute	d@`spj}:t
disqualify	dIs`kwOl@fAe
disregard	dIsr\@`g6:d
disrepair	dIsr\@`pe:
disreputable	dIs`r\epj@t@b@l
disrepute	dIsr\@`pj}:t
disrespect	dIsr\@`spekt
disrupt	dIs`r\6pt
dissatisfied	dIs`s{t@sfAed
dissect	d@`sekt
dissension	d@`senS@n
dissent	d@`sent
dissertation	dIs@`t{IS@n
dissident	`dIs@d@nt
dissimilar	dIs`sIm@l@
dissipate	`dIs@p{It
dissociate	dIs`s@}si:{It
dissolution	dIs@`l}:S@n
dissolve	d@`zOlv
dissuade	dIs`sw{Id
distance	`dIst@ns
distant	`dIst@nt
distasteful	dIs`t{IstfUl
distend	d@`stend
distil	d@`stIl
distillate	`dIst@l@t
distinct	d@`stINkt
distinction	d@`stINkS@n
distinctive	d@`stINktIv
distinguish	d@`stINgwIS
distort	d@`sto:t
distract	d@`str\{kt
distraught	d@`str\o:t
distress	d@`str\es
distribute	d@`str\Ibj}:t
distribution	dIstr\@`bj}:S@n
district	`dIstr\Ikt
distrust	dIs`tr\6st
disturb	d@`st3:b
disturbance	d@`st3:b@ns
disturbed	d@`st3:bd
disuse	dIs`j}:s
ditch	dItS
dither	`dID@
ditto	`dIt@}
divan	d@`v{n
dive	dAev
diver	`dAev@
diverge	dAe`v3:dZ
diverse	dAe`v3:s
diversify	d@`v3:s@fAe
diversion	d@`v3:Z@n
divide	d@`vAed
dividend	`dIv@dend
divination	dIv@`n{IS@n
divine	d@`vAen
divinity	d@`vIn@ti:
division	d@`vIZ@n
divorce	d@`vo:s
divorcee	d@vo:`si:
divulge	d@`v6ldZ
dizzy	`dIzi:
do	d}:
dob	dOb
docile	`d@}sAel
dock	dOk
docket	`dOk@t
dockyard	`dOkj6:d
doctor	`dOkt@
doctors	dOkt@z
doctrine	`dOktr\@n
document	`dOkj@m@nt
documentary	dOkj@`mentr\i:
dodge	dOdZ
dodgy	`dOdZi:
doe	d@}
does	d6z
dog	dOg
dog-ear	`dOgI@
dogged	`dOg@d
dogleg	`dOgleg
dogma	`dOgm@
dogmatic	dOg`m{tIk
doily	`doIli:
doing	`d}:IN
doldrums	`dOldr\@mz
dole	d@}l
doleful	`d@}lfUl
doll	dOl
doll's	dOlz
dollar	`dOl@
dollop	`dOl@p
dolls	dOlz
domain	d@`m{In
dome	d@}m
domestic	d@`mestIk
domesticate	d@`mest@k{It
dominate	`dOm@n{It
domineering	dOm@`nI@r\IN
don't	d@}nt
donate	d@}`n{It
done	d6n
donkey	`dONki:
donor	`d@}n@
dont	d@}nt
doodle	`d}:d@l
doom	d}:m
doomsday	`d}:mzd{I
doona	`d}:n@
door	do:
dope	d@}p
dopey	`d@}pi:
dork	do:k
dorm	do:m
dormant	`do:m@nt
dormitory	`do:m@tr\i:
dose	d@}s
dossier	`dOsi:@
dot	dOt
dote	d@}t
dots	dOts
dotty	`dOti:
double	`d6b@l
doublecross	d6b@l`kr\Os
doubt	d{Ot
doubtful	`d{OtfUl
dough	d@}
dour	dU@
douse	d{Os
dove	d6v
dowdy	`d{Odi:
down	d{On
down-market	d{On`m6:k@t
down-to-earth	d{Ont}:`3:T
downcast	`d{Onk6:st
downfall	`d{Onfo:l
downgrade	d{On`gr\{Id
downhearted	d{On`h6:t@d
downhill	d{On`hIl
downplay	d{On`pl{I
downpour	`d{Onpo:
downstream	d{On`str\i:m
downtown	d{Ont{On
downtrodden	d{On`tr\Od@n
downturn	`d{Ont3:n
downward	`d{Onw@d
downwards	`d{Onw@dz
downwind	d{On`wInd
downy	`d{Oni:
dowry	`d{Or\i:
doz.	`d6z@n
doze	d@}z
dozen	`d6z@n
Dr	`dOkt@
drab	dr\{b
draft	dr\6:ft
drag	dr\{g
dragon	`dr\{g@n
dragonfly	`dr\{g@nflAe
drain	dr\{In
drake	dr\{Ik
drama	`dr\6:m@
dramatic	dr\@`m{tIk
dramatise	`dr\{m@tAez
drank	dr\{Nk
drape	dr\{Ip
drastic	`dr\{stIk
draught	dr\6:ft
draw	dr\o:
drawback	`dr\o:b{k
drawcard	`dr\o:k6:d
drawer	dr\o:
drawing	dr\o:IN
drawing-pin	`dr\o:r\INpIn
drawl	dr\o:l
drawn	dr\o:n
dread	dr\ed
dreadful	`dr\edfUl
dream	dr\i:m
Dreaming	`dr\i:mIN
dreamt	dr\emt
dreary	`dr\I@r\i:
drench	dr\entS
dress	dr\es
dresser	`dr\es@
dressing	`dr\esIN
dressing-gown	`dr\esINg{On
dressing-table	`dr\esINt{Ib@l
dressmaker	`dr\esm{Ik@
drew	dr\}:
dribble	`dr\Ib@l
dried	dr\Aed
drier	`dr\Ae@
drift	dr\Ift
drill	dr\Il
drink	dr\INk
drink-driving	dr\INk`dr\AevIN
drip	dr\Ip
drip-dry	`dr\Ipdr\Ae
dripping	`dr\IpIN
drive	dr\Aev
drive-in	`dr\AevIn
driveway	`dr\Aevw{I
drizzle	`dr\Iz@l
drone	dr\@}n
drongo	`dr\ONg@}
droop	dr\}:p
drop	dr\Op
drop-out	`dr\Op{Ot
droplet	`dr\Opl@t
dropper	`dr\Op@
droppings	`dr\OpINz
drought	dr\{Ot
drove	dr\@}v
drown	dr\{On
drowsy	`dr\{Ozi:
drug	dr\6g
drum	dr\6m
drumstick	`dr\6mstIk
drunk	dr\6Nk
dry	dr\Ae
dry-clean	dr\Ae`kli:n
dual	`dj}:@l
dub	d6b
dubious	`dj}:bi:@s
duck	d6k
due	dj}:
duel	`dj}:@l
duet	dj}:`et
dug	d6g
dugout	`d6g{Ot
dull	d6l
duly	`dj}:li:
dumb	d6m
dummy	`d6mi:
dump	d6mp
dumpling	`d6mplIN
dumpy	`d6mpi:
dune	dj}:n
dung	d6N
dunk	d6Nk
dunny	`d6ni:
duo	`dj}:@}
duodenum	dj}:@`di:n@m
dupe	dj}:p
duplex	`dj}:pleks
duplicate	`dj}:pl@k{It
durable	`dj}:r\@b@l
duration	dj}:`r\{IS@n
during	`dj}:r\IN
dusk	d6sk
dust	d6st
dustpan	`d6stp{n
Dutch	d6tS
duty	`dj}:ti:
duty-free	dj}:ti:`fr\i:
duvet	`d}:v{I
dwarf	dwo:f
dwarf's	dwo:fs
dwell	dwel
dwindle	`dwInd@l
dye	dAe
dying	`dAeIN
dynamic	dAe`n{mIk
dynamics	dAe`n{mIks
dynamite	`dAen@mAet
dysentery	`dIs@ntr\i:
dyslexia	dIs`leksi:@
E	i:
e	i:
e-mail	`i:m{Il
e.g.	i:`dZi:
each	i:tS
eager	`i:g@
ear	I@
eardrum	`I@dr\6m
early	`3:li:
earn	3:n
earnest	`3:n@st
earphone	`I@f@}n
earring	`I@r\IN
earth	3:T
earthenware	`3:D@nwe:
earthquake	`3:Tkw{Ik
ease	i:z
easel	`i:z@l
east	i:st
Easter	`i:st@
eastward	`i:stw@d
easy	`i:zi:
eat	i:t
eaves	i:vz
eavesdrop	`i:vzdr\Op
EB	i:`bi:
ebb	eb
eccentric	ek`sentr\Ik
ECG	i:si:`dZi:
echidna	@`kIdn@
echo	`ek@}
eclipse	@`klIps
ecology	@`kOl@dZi:
economics	ek@`nOmIks
economy	@`kOn@mi:
eczema	`eks@m@
edge	edZ
edible	`ed@b@l
edit	`ed@t
edition	@`dIS@n
editorial	ed@`to:r\i:@l
education	edZ@`k{IS@n
eerie	`I@r\i:
effect	@`fekt
effective	@`fektIv
effeminate	@`fem@n@t
effervescent	ef@`ves@nt
efficient	@`fIS@nt
effort	`ef@t
EFTPOS	`eftpOs
egg	eg
ego	`i:g@}
eiderdown	`Aed@d{On
eight	{It
eighteen	{I`ti:n
eighteenth	{I`ti:nT
eighth	{ItT
eighty	`{Iti:
either	`AeD@
eject	@`dZekt
elaborate	@`l{b@r\@t
elapse	@`l{ps
elastic	@`l{stIk
elated	@`l{It@d
elbow	`elb@}
elder	`eld@
elderly	`eld@li:
eldest	`eld@st
elect	@`lekt
election	@`lekS@n
elective	@`lektIv
electorate	@`lekt@r\@t
electrician	@lek`tr\IS@n
electricity	@lek`tr\Is@ti:
electrocute	@`lektr\@kj}:t
electronic	el@k`tr\OnIk
elegant	`el@g@nt
element	`el@m@nt
elementary	el@`mentr\i:
elevate	`el@v{It
elevator	`el@v{It@
eleven	@`lev@n
eleventh	@`lev@nT
eligible	`el@dZ@b@l
eliminate	@`lIm@n{It
elite	@`li:t
Elle	el
Ellen	el@n
ellipse	@`lIps
eloquent	`el@kw@nt
else	els
elsewhere	`elswe:
elusive	@`l}:sIv
embargo	em`b6:g@}
embark	em`b6:k
embarrass	em`b{r\@s
embassy	`emb@si:
embezzle	em`bez@l
emblem	`embl@m
embrace	em`br\{Is
embroider	em`br\oId@
embryo	`embr\i:@}
emerald	`emr\@ld
emerge	@`m3:dZ
emergency	@`m3:dZ@nsi:
emigrant	`em@gr\@nt
emigrate	`em@gr\{It
eminent	`em@n@nt
emotion	@`m@}S@n
emphasis	`emf@s@s
empire	`empAe@
employ	em`ploI
empty	`empti:
emu	`i:mj}:
enable	en`{Ib@l
enamel	@`n{m@l
encircled	ens3:k@ld
enclose	en`kl@}z
encode	en`k@}d
encore	`ONko:
encounter	en`k{Ont@
encourage	en`k6r\IdZ
encyclopedia	ensAekl@`pi:di:@
end	end
endanger	en`d{IndZ@
endeavour	en`dev@
endorse	en`do:s
endure	en`djU@
enemy	`en@mi:
energy	`en@dZi:
engage	en`g{IdZ
engagement	en`g{IdZm@nt
engine	`endZ@n
engineer	endZ@`nI@
English	`INglIS
engrave	en`gr\{Iv
enjoy	en`dZoI
enjoying	endZoIIN
enlarge	en`l6:dZ
enlist	en`lIst
enormous	@`no:m@s
enough	@`n6f
enquiry	In`kwAer\i:
enrage	en`r\{IdZ
enrich	en`r\ItS
enrol	en`r\@}l
ensuite	`Onswi:t
ensure	en`So:
entangled	en`t{Ng@ld
enter	`ent@
enterprise	`ent@pr\Aez
entertain	ent@`t{In
enthusiasm	en`T}:zi:{z@m
entice	en`tAes
entire	en`tAe@
entitle	en`tAet@l
entrance	`entr\@ns
entrant	`entr\@nt
entreat	en`tr\i:t
entree	`Ontr\{I
entrepreneur	Ontr\@pr\@`n3:
entry	`entr\i:
envelope	`env@l@}p
environment	en`vAer\@nm@nt
envy	`envi:
epic	`epIk
epidemic	ep@`demIk
epilepsy	`ep@lepsi:
episode	`ep@s@}d
epitome	@`pIt@mi:
epoch	`i:pOk
equal	`i:kw@l
equator	@`kw{It@
equip	@`kwIp
equipment	@`kwIpm@nt
equivalent	@`kwIv@l@nt
era	`I@r\@
eradicate	@`r\{d@k{It
erase	@`r\{Iz
erect	@`r\ekt
erode	@`r\@}d
erotic	@`r\OtIk
err	3:
errand	`er\@nd
erratic	@`r\{tIk
error	`er\@
erupt	@`r\6pt
escalate	`esk@l{It
escalator	`esk@l{It@
escapade	`esk@p{Id
escape	@`sk{Ip
escort	@s`ko:t
esky	`eski:
ESL	i:es`el
especially	@`speS@li:
espionage	`espi:@n6:Z
essay	`es{I
essence	`es@ns
essential	@`senS@l
establish	@`st{blIS
establishment	@`st{blISm@nt
estate	@`st{It
esteem	@`sti:m
estimate	`est@m{It
estranged	@`str\{IndZd
etc.	et`setr\@
etch	etS
etching	`etSIN
eternal	@`t3:n@l
Ethan	i:T@n
ethics	`eTIks
ethnic	`eTnIk
etiquette	`eti:k@t
eucalyptus	j}:k@`lIpt@s
euthanasia	j}:T@`n{IZ@
evacuate	@`v{kj}:{It
evade	@`v{Id
evaluate	@`v{lj}:{It
evaporate	@`v{p@r\{It
eve	i:v
even	`i:v@n
evening	`i:vnIN
event	@`vent
eventually	@`ventS@li:
ever	`ev@
evergreen	`ev@gr\i:n
every	`evr\i:
everybody	`evr\i:bOdi:
everyday	`evr\i:d{I
everyone	`evr\i:w6n
everything	`evr\i:TIN
everywhere	`evr\i:we:
evict	@`vIkt
evidence	`ev@d@ns
evident	`ev@d@nt
evil	`i:v@l
evolution	ev@`l}:S@n
ex-	eks
exact	@g`z{kt
exactly	@g`z{ktli:
exaggerate	@g`z{dZ@r\{It
exam	@g`z{m
examination	@gz{m@`n{IS@n
examine	@g`z{m@n
example	@g`z{mp@l
exasperate	@g`z{sp@r\{It
excavate	`eksk@v{It
exceed	@k`si:d
excel	@k`sel
excellent	`eks@l@nt
except	@k`sept
exception	@k`sepS@n
exceptional	@k`sepS@n@l
excess	`ekses
exchange	@ks`tS{IndZ
excite	@k`sAet
excited	@k`sAet@d
exciting	@k`sAetIN
exclaim	@k`skl{Im
exclamation	ekskl@`m{IS@n
exclude	@k`skl}:d
exclusive	@k`skl}:sIv
excrete	@k`skr\i:t
excruciating	@k`skr\}:Si:{ItIN
excursion	@k`sk3:S@n
excuse	@k`skj}:s
execute	`eks@kj}:t
executive	@g`zekj@tIv
executor	@g`zekj@t@
exempt	@g`zempt
exercise	`eks@sAez
exert	@g`z3:t
exhale	eks`h{Il
exhaust	@g`zo:st
exhaustive	@g`zo:stIv
exhibit	@g`zIb@t
exile	`egzAel
exist	@g`zIst
exit	`eks@t
exodus	`eks@d@s
exotic	@g`zOtIk
expand	@k`sp{nd
expanse	@k`sp{ns
expect	@k`spekt
expected	ekspekt@d
expedition	eksp@`dIS@n
expel	@k`spel
expend	@k`spend
expenditure	ek`spend@tS@
expense	@k`spens
expensive	@k`spensIv
experience	@k`spI@r\i:ens
experiment	@k`sper\@m@nt
expert	`eksp3:t
expire	@k`spAe@
explain	@k`spl{In
expletive	@k`spli:tIv
explode	@k`spl@}d
exploit	@k`sploIt
explore	@k`splo:
explosion	@k`spl@}Z@n
explosive	ek`spl@}sIv
export	ek`spo:t
expose	@k`sp@}z
exposure	@k`sp@}Z@
express	@k`spr\es
expression	@k`spr\eS@n
expressway	ek`spr\esw{I
expulsion	@k`sp6lS@n
exquisite	ek`skwIz@t
extend	@k`stend
extension	@k`stenS@n
extensive	@k`stensIv
extent	@k`stent
exterior	@k`stI@r\i:@
exterminate	@k`st3:m@n{It
external	@k`st3:n@l
extinct	@k`stINkt
extinguish	@k`stINgwIS
extortion	@k`sto:S@n
extra	`ekstr\@
extract	@k`str\{kt
extraordinary	@k`str\o:d@nr\i:
extravagant	@k`str\{v@g@nt
extreme	@k`str\i:m
extremism	@k`str\i:mIz@m
eye	Ae
eyebrow	`Aebr\{O
eyelash	`Ael{S
eyelid	`AelId
eyesight	`AesAet
eyesore	`Aeso:
eyewitness	`AewItn@s
F	ef
f	ef
fable	`f{Ib@l
fabric	`f{br\Ik
fabricate	`f{br\@k{It
fabulous	`f{bj}:l@s
facade	f@`s6:d
face	f{Is
faceless	`f{Isl@s
facelift	`f{IslIft
facet	`f{s@t
facial	f{IS@l
facilitate	f@`sIl@t{It
facility	f@`sIl@ti:
facsimile	f{k`sIm@li:
fact	f{kt
faction	`f{kS@n
factor	`f{kt@
factory	`f{ktr\i:
factual	`f{ktS}:@l
faculty	`f{k@lti:
fad	f{d
fade	f{Id
faeces	`fi:si:z
fag	f{g
Fahrenheit	`f{r\@nhAet
fail	f{Il
failing	`f{IlIN
failure	`f{Ilj@
faint	f{Int
fair	fe:
fairly	`fe:li:
fairway	`fe:w{I
fairy	`fe:r\i:
fairytale	`fe:r\i:t{Il
faith	f{IT
faithful	`f{ITf@l
fake	f{Ik
fall	fo:l
fallacy	`f{l@si:
fallible	`f{l@b@l
fallout	`fo:l{Ot
false	fOls
falter	`fo:lt@
fame	f{Im
familiar	f@`mIlj@
family	`f{m@li:
famine	`f{m@n
famished	`f{mISt
famous	`f{Im@s
fan	f{n
fanatic	f@`n{tIk
fanbelt	`f{nbelt
fanciful	`f{ns@f@l
fancy	`f{nsi:
fang	f{N
fantastic	f{n`t{stIk
fantasy	`f{nt@si:
far	f6:
far-fetched	f6:`fetSt
far-reaching	f6:`r\i:tSIN
far-sighted	f6:`sAet@d
farce	f6:s
fare	fe:
farewell	fe:`wel
farm	f6:m
fart	f6:t
farther	`f6:D@
fascinate	`f{s@n{It
fashion	`f{S@n
fast	f6:st
fasten	`f6:s@n
fat	f{t
fatal	`f{It@l
fatalistic	f{It@`lIstIk
fatality	f@`t{l@ti:
fate	f{It
father	`f6:D@
father-in-law	`f6:D@r\Inlo:
fatigue	f@`ti:g
fatso	`f{ts@}
fault	fOlt
fauna	`fo:n@
favour	`f{Iv@
favourable	`f{Iv@r\@b@l
favourite	`f{Iv@r\@t
fax	f{ks
faze	f{Iz
fear	fI@
fearful	`fI@f@l
feasible	`fi:z@b@l
feast	fi:st
feat	fi:t
feather	`feD@
feature	`fi:tS@
February	`febr\}:@r\i:
fed	fed
federal	`fed@r\@l
federate	`fed@r\{It
fee	fi:
feeble	`fi:b@l
feed	fi:d
feedback	`fi:db{k
feel	fi:l
feeler	`fi:l@
feeling	`fi:lIN
feet	fi:t
feign	f{In
fell	fel
fellow	`fel@}
felony	`fel@ni:
felt	felt
female	`fi:m{Il
feminine	`fem@n@n
feminist	`fem@n@st
fence	fens
fencing	`fensIN
fend	fend
feral	`fer\@l
ferment	f@`ment
ferocious	f@`r\@}S@s
ferry	`fer\i:
fertile	`f3:tAel
fertilisation	f3:t@lAe`z{IS@n
fertiliser	`f3:t@lAez@
fervent	`f3:v@nt
fester	`fest@
festival	`fest@v@l
festive	`festIv
festoon	fes`t}:n
fetch	fetS
fete	f{It
fetid	`fet@d
fetus	`fi:t@s
feud	fj}:d
fever	`fi:v@
few	fj}:
fiance	fi:`Ons{I
fiancee	fi:`Ons{I
fiasco	fi:`{sk@}
fib	fIb
fibre	`fAeb@
fibreglass	`fAeb@gl6:s
fibro	`fAebr\@}
fiction	`fIkS@n
fiddle	`fId@l
fiddly	`fIdli:
fidelity	f@`del@ti:
fidget	`fIdZ@t
field	fi:ld
fierce	fI@s
fiery	`fAe@r\i:
fifteen	fIf`ti:n
fifteenth	fIf`ti:nT
fifth	fIfT
fifty	`fIfti:
fight	fAet
figment	`fIgm@nt
figure	`fIg@
file	fAel
filial	`fIli:@l
filing	`fAelIN
Filipino	fIl@`pi:n@}
fill	fIl
fillet	`fIl@t
filling	`fIlIN
film	fIlm
filmed	fIlmd
filter	`fIlt@
filthy	`fIlTi:
fin	fIn
final	`fAen@l
finale	f@`n6:li:
finalise	`fAen@lAez
finalist	`fAen@l@st
finally	`fAen@li:
finance	`fAen{ns
financial	f@`n{nS@l
find	fAend
fine	fAen
finger	`fINg@
fingernail	`fINg@n{Il
fingerprint	`fINg@pr\Int
finicky	`fIn@ki:
finish	`fInIS
finite	`fAenAet
fire	fAe@
firearm	`fAe@r\6:m
firebreak	`fAe@br\{Ik
firefighter	`fAe@fAet@
fireplace	`fAe@pl{Is
fireproof	`fAe@pr\}:f
firewood	`fAe@wUd
fireworks	`fAe@w3:ks
firm	f3:m
first	f3:st
first-class	`f3:stkl6:s
first-hand	`f3:sth{nd
fish	fIS
fisherman	`fIS@m@n
fishing	fISIN
fishy	`fISi:
fist	fIst
fit	fIt
fitness	`fItn@s
fitting	`fItIN
five	fAev
fix	fIks
fixture	`fIkstS@
fizz	fIz
fizzer	`fIz@
fizzle	`fIz@l
flab	fl{b
flabbergasted	`fl{b@g{st@d
flaccid	`fl{s@d
flag	fl{g
flagon	`fl{g@n
flagrant	`fl{Igr\@nt
flair	fle:
flak	fl{k
flake	fl{Ik
flamboyant	fl{m`boI@nt
flame	fl{Im
flaming	`fl{ImIN
flammable	`fl{m@b@l
flan	fl{n
flank	fl{Nk
flannel	`fl{n@l
flannelette	fl{n@`let
flap	fl{p
flapjack	`fl{pdZ{k
flare	fle:
flash	fl{S
flashback	`fl{Sb{k
flashlight	`fl{SlAet
flashy	`fl{Si:
flask	fl6:sk
flat	fl{t
flatette	fl{t`et
flatten	`fl{t@n
flatter	`fl{t@
flatulence	`fl{tS@l@ns
flaunt	flo:nt
flautist	`flo:t@st
flavour	`fl{Iv@
flaw	flo:
flax	fl{ks
flea	fli:
flea-bitten	`fli:bIt@n
fled	fled
fledgling	`fledZlIN
flee	fli:
fleece	fli:s
fleet	fli:t
fleeting	`fli:tIN
flesh	fleS
flew	fl}:
flex	fleks
flexible	`fleks@b@l
flexitime	`fleksi:tAem
flick	flIk
flicker	`flIk@
flicks	flIks
flight	flAet
flimsy	`flImzi:
flinch	flIntS
fling	flIN
flint	flInt
flip	flIp
flippant	`flIp@nt
flipper	`flIp@
flirt	fl3:t
flit	flIt
float	fl@}t
flock	flOk
flog	flOg
flood	fl6d
floodlight	`fl6dlAet
floor	flo:
floorboard	`flo:bo:d
flop	flOp
floppy	`flOpi:
flora	`flo:r\@
floral	`flOr\@l
florist	`flOr\@st
floss	flOs
flounder	fl{Ond@
flour	`fl{O@
flourish	`fl6r\IS
flout	fl{Ot
flow	fl@}
flower	`fl{O@
flowerbed	`fl{O@bed
flowery	`fl{O@r\i:
flown	fl@}n
flu	fl}:
fluctuate	`fl6ktS}:{It
flue	fl}:
fluent	`fl}:@nt
fluff	fl6f
fluid	`fl}:@d
fluke	fl}:k
flunk	fl6Nk
fluorescent	flU@`r\es@nt
fluoride	`flU@r\Aed
flurry	`fl6r\i:
flush	fl6S
fluster	`fl6st@
flute	fl}:t
flutter	`fl6t@
fly	flAe
foal	f@}l
foam	f@}m
fob	fOb
focus	`f@}k@s
fodder	`fOd@
foetus	`fi:t@s
fog	fOg
foil	foIl
fold	f@}ld
folder	`f@}ld@
foliage	`f@}li:IdZ
folk	f@}k
folklore	`f@}klo:
follow	`fOl@}
follow-up	`fOl@}6p
follower	`fOl@}@
following	`fOl@}IN
folly	`fOli:
fond	fOnd
food	f}:d
foodstuff	`f}:dst6f
fool	f}:l
foolproof	`f}:lpr\}:f
foot	fUt
football	`fUtbo:l
footing	`fUtIN
footnote	`fUtn@}t
footpath	`fUtp6:T
footprint	`fUtpr\Int
footstep	`fUtstep
footwear	`fUtwe:
for	fo:
forage	`fOr\IdZ
forbearance	fo:`be:r\@ns
forbid	f@`bId
forbidding	f@`bIdIN
force	fo:s
forceful	`fo:sfUl
forceps	`fo:s@ps
forcible	`fo:s@b@l
ford	fo:d
fore	fo:
forearm	`fo:r\6:m
forebear	`fo:be:
forecast	`fo:k6:st
forefinger	`fo:fINg@
foreground	`fo:gr\{Ond
forehead	`fOr\@d
foreign	`fOr\@n
foreman	`fo:m@n
foremost	`fo:m@}st
forensic	f@`r\ensIk
foresee	fo:`si:
foreshadow	fo:`S{d@}
forest	`fOr\@st
forestry	`fOr\@str\i:
forever	f@r\`ev@
foreword	`fo:w3:d
forfeit	`fo:f@t
forge	fo:dZ
forget	f@`get
forgive	f@`gIv
fork	fo:k
forklift	`fo:klIft
forlorn	f@`lo:n
form	fo:m
formal	`fo:m@l
format	`fo:m{t
formation	fo:`m{IS@n
former	`fo:m@
formidable	`fo:m@d@b@l
formula	`fo:mj@l@
formulate	`fo:mj@l{It
forsake	f@`s{Ik
fort	fo:t
forte	`fo:t{I
forth	fo:T
forthcoming	fo:T`k6mIN
forthright	`fo:Tr\Aet
fortify	`fo:t@fAe
fortnight	`fo:tnAet
fortress	`fo:tr\@s
fortunate	`fo:tS@n@t
fortune	`fo:tS@n
forty	`fo:ti:
forum	`fo:r\@m
forward	`fo:w@d
fossick	`fOsIk
fossil	`fOs@l
foster	`fOst@
fought	fo:t
foul	f{Ol
foul-mouthed	`f{Olm{ODd
found	f{Ond
foundation	f{On`d{IS@n
fountain	`f{Ont@n
four	fo:
fourteen	`fo:ti:n
fourteenth	fo:`ti:nT
fourth	fo:T
fox	fOks
foyer	`foI@
fraction	`fr\{kS@n
fracture	`fr\{ktS@
fragile	`fr\{dZAel
fragment	`fr\{gm@nt
fragrance	`fr\{Igr\@ns
frail	fr\{Il
frame	fr\{Im
framework	`fr\{Imw3:k
franchise	`fr\{ntSAez
frank	fr\{Nk
frankfurt	`fr\{Nkf@t
frantic	`fr\{ntIk
fraternal	fr\@`t3:n@l
fraud	fr\o:d
fraught	fr\o:t
fray	fr\{I
frazzled	`fr\{z@ld
freak	fr\i:k
freckle	`fr\ek@l
free	fr\i:
free-for-all	`fr\i:f@r\o:l
free-range	`fr\i:r\{IndZ
freebie	`fr\i:bi:
freedom	`fr\i:d@m
freehand	`fr\i:h{nd
freehold	`fr\i:h@}ld
freelance	`fr\i:l{ns
freeloader	`fr\i:l@}d@
freestyle	`fr\i:stAel
freeway	`fr\i:w{I
freeze	fr\i:z
freeze-dry	`fr\i:zdr\Ae
freezer	`fr\i:z@
freight	fr\{It
French	fr\entS
frenetic	fr\@`netIk
frenzy	`fr\enzi:
frequency	`fr\i:kw@nsi:
frequent	`fr\i:kw@nt
fresh	fr\eS
freshwater	`fr\eSwo:t@
fret	fr\et
friction	`fr\IkS@n
Friday	`fr\Aed{I
friday	fr\Aed{I
fridge	fr\IdZ
fried	fr\Aed
friend	fr\end
friendly	`fr\endli:
friends	fr\endz
friendship	`fr\endSIp
fright	fr\Aet
frighten	`fr\Aet@n
frightful	`fr\AetfUl
frill	fr\Il
fringe	fr\IndZ
frisk	fr\Isk
fritter	`fr\It@
frivolous	`fr\Iv@l@s
frizzy	`fr\Izi:
frock	fr\Ok
frog	fr\Og
frogman	`fr\Ogm@n
frolic	`fr\OlIk
from	fr\Om
front	fr\6nt
frontier	fr\6n`tI@
frost	fr\Ost
frostbite	`fr\OstbAet
froth	fr\OT
frown	fr\{On
froze	fr\@}z
frozen	`fr\@}z@n
frugal	`fr\}:g@l
fruit	fr\}:t
fruitcake	`fr\}:tk{Ik
frustrate	fr\6s`tr\{It
fry	fr\Ae
fuck	f6k
fuckwit	`f6kwIt
fudge	f6dZ
fuel	`fj}:@l
fugitive	`fj}:dZ@tIv
fulfil	fUl`fIl
full	fUl
full-time	fUl`tAem
fully-fledged	`fUli:fledZd
fumble	`f6mb@l
fume	fj}:m
fumigate	`fj}:m@g{It
fun	f6n
function	`f6NkS@n
functional	`f6NkS@n@l
fund	f6nd
fundamental	f6nd@`ment@l
funeral	`fj}:nr\@l
fungus	`f6Ng@s
funnel	`f6n@l
funnel-web	`f6n@lweb
funny	`f6ni:
fur	f3:
furious	`fj}:r\i:@s
furnace	`f3:n@s
furnish	`f3:nIS
furniture	`f3:nItS@
furore	`fj}:r\o:
furrow	`f6r\@}
further	`f3:D@
furthest	`f3:D@st
furtive	`f3:tIv
fury	`fj}:r\i:
fuse	fj}:z
fuss	f6s
fussy	`f6si:
futile	`fj}:tAel
future	`fj}:tS@
fuzz	f6z
fuzzy	`f6zi:
G	dZi:
g	dZi:
gable	`g{Ib@l
gadget	`g{dZ@t
gaffe	g{f
gag	g{g
gaggle	`g{g@l
gaiety	`g{I@ti:
gain	g{In
gait	g{It
gala	`g6:l@
galah	g@`l6:
galaxy	`g{l@ksi:
gale	g{Il
gallery	`g{l@r\i:
gallon	`g{l@n
gallop	`g{l@p
gallstone	`go:lst@}n
galore	g@`lo:
galvanise	`g{lv@nAez
gamble	`g{mb@l
game	g{Im
gaming	`g{ImIN
gang	g{N
gangrene	`g{Ngr\i:n
gangster	`g{Nst@
gaol	dZ{Il
gap	g{p
gape	g{Ip
garage	`g{r\6:Z
garbage	`g6:bIdZ
garden	`g6:d@n
gardener	`g6:dn@
gargle	`g6:g@l
garish	`ge:r\IS
garlic	`g6:lIk
garment	`g6:m@nt
garnish	`g6:nIS
garret	`g{r\@t
gas	g{s
gash	g{S
gasket	`g{sk@t
gasp	g{sp
gastric	`g{str\Ik
gate	g{It
gatecrash	`g{Itkr\{S
gather	`g{D@
gaudy	`go:di:
gauge	g{IdZ
gaunt	go:nt
gauze	go:z
gave	g{Iv
gavel	g{v@l
gawk	go:k
gawky	`go:ki:
gay	g{I
gaze	g{Iz
gazelle	g@zel
gazump	g@`z6mp
GDP	dZi:di:`pi:
gear	gI@
gel	dZel
gelatine	`dZel@ti:n
gem	dZem
gender	`dZend@
gene	dZi:n
general	`dZenr\@l
generate	`dZen@r\{It
generation	dZen@`r\{IS@n
generic	dZ@`ner\Ik
generous	`dZen@r\@s
genesis	`dZen@s@s
genetics	dZ@`netIks
genial	`dZi:ni:@l
genitals	`dZen@t@lz
genius	`dZi:ni:@s
genocide	`dZen@sAed
genre	`ZOnr\@
gentile	`dZentAel
gentle	`dZent@l
gentleman	`dZent@lm@n
genuine	`dZenj}:@n
geography	dZi:`Ogr\@fi:
geology	dZi:`Ol@dZi:
geometry	dZi:`Om@tr\i:
geriatric	dZer\i:`{tr\Ik
geriatrics	dZer\i:`{tr\Iks
germ	dZ3:m
German	`dZ3:m@n
gerrymander	`dZer\i:m{nd@
gesticulate	dZes`tIkj@l{It
gesture	`dZestS@
get	get
gets	gets
ghastly	`g6:stli:
gherkin	`g3:k@n
ghetto	`get@}
ghost	g@}st
giant	`dZAe@nt
gibber	`dZIb@
gibberish	`dZIb@r\IS
giddy	`gIdi:
gift	gIft
gigantic	dZAe`g{ntIk
giggle	`gIg@l
gild	gIld
gilt	gIlt
gimmick	`gImIk
ginger	`dZIndZ@
gingerly	`dZIndZ@li:
gingham	`gIN@m
gipsy	`dZIpsi:
girl	g3:l
girlfriend	`g3:lfr\end
girls'	g3:lz
girth	g3:T
gist	dZIst
give	gIv
given	gIv@n
glacier	`gl{Isi:@
glad	gl{d
glamour	`gl{m@
glance	gl{ns
gland	gl{nd
glare	gle:
glaring	`gle:r\IN
glass	gl6:s
gleam	gli:m
glean	gli:n
Glebe	gli:b
glee	gli:
glib	glIb
glide	glAed
glimmer	`glIm@
glimpse	glImps
glimpsed	glImpst
glint	glInt
glisten	`glIs@n
glitter	`glIt@
gloat	gl@}t
globe	gl@}b
gloomy	`gl}:mi:
glorious	`glo:r\i:@s
glory	`glo:r\i:
gloss	glOs
glossary	`glOs@r\i:
glove	gl6v
glow	gl@}
glucose	`gl}:k@}s
glue	gl}:
glued	gl}:d
glum	gl6m
glut	gl6t
glutton	`gl6t@n
gnash	n{S
gnaw	no:
GNP	dZi:en`pi:
go	g@}
goal	g@}l
goalkeeper	`g@}lki:p@
goat	g@}t
gobble	`gOb@l
god	gOd
goggle	`gOg@l
gold	g@}ld
golden	`g@}ld@n
goldmine	`g@}ldmAen
golf	gOlf
gone	gOn
gonorrhoea	gOn@`r\i:@
good	gUd
goodbye	gUd`bAe
goodness	`gUdn@s
goods	gUdz
goose	g}:s
gorge	go:dZ
gorgeous	`go:dZ@s
gosh	gOS
gossip	`gOs@p
got	gOt
gouge	g{OdZ
gourmet	`go:m{I
gout	g{Ot
govern	`g6v@n
government	`g6v@nm@nt
Governor	`g6v@n@
Governor-General	g6v@n@`dZenr\@l
gown	g{On
GP	dZi:`pi:
GPO	dZi:pi:`@}
grab	gr\{b
grabbed	gr\{bd
grace	gr\{Is
gracious	`gr\{IS@s
grade	gr\{Id
gradual	`gr\{dZ}:@l
graduate	`gr\{dZ}:@t
graffiti	gr\@`fi:ti:
graft	gr\6:ft
grain	gr\{In
gram	gr\{m
grammar	`gr\{m@
gran	gr\{n
grand	gr\{nd
grandchild	`gr\{ntSAeld
granddaughter	`gr\{ndo:t@
grandfather	`gr\{nf6:D@
grandiose	`gr\{ndi:@}s
grandmother	`gr\{nm6D@
grandparent	`gr\{npe:r\@nt
grandson	`gr\{ns6n
grandstand	`gr\{nst{nd
granite	`gr\{n@t
grant	gr\{nt
grape	gr\{Ip
graph	gr\{f
graphic	`gr\{fIk
graphite	`gr\{fAet
grapple	`gr\{p@l
grasp	gr\{sp
grasping	`gr\{spIN
grass	gr\6:s
grassroots	gr\6:s`r\}:ts
grate	gr\{It
grateful	`gr\{ItfUl
grater	`gr\{It@
grating	`gr\{ItIN
gratitude	`gr\{t@tS}:d
grave	gr\{Iv
gravel	`gr\{v@l
graveyard	`gr\{Ivj6:d
gravitate	`gr\{v@t{It
gravity	`gr\{v@ti:
gravy	`gr\{Ivi:
graze	gr\{Iz
grazier	`gr\{Izi:@
grease	gr\i:s
greaseproof	`gr\i:spr\}:f
great	gr\{It
greedy	`gr\i:di:
Greek	gr\i:k
green	gr\i:n
greengrocer	`gr\i:ngr\@}s@
greenhouse	`gr\i:nh{Os
greet	gr\i:t
greeting	`gr\i:tIN
grenade	gr\@`n{Id
grevillea	gr\@`vIli:@
grew	gr\}:
grey	gr\{I
grid	gr\Id
grief	gr\i:f
grievance	`gr\i:v@ns
grill	gr\Il
grille	gr\Il
grim	gr\Im
grimace	`gr\Im@s
grime	gr\Aem
grin	gr\In
grind	gr\Aend
grip	gr\Ip
gripe	gr\Aep
grisly	`gr\Izli:
gristle	`gr\Is@l
grit	gr\It
grizzle	`gr\Iz@l
groan	gr\@}n
grocer	`gr\@}s@
groceries	`gr\@}s@r\i:z
grog	gr\Og
groggy	`gr\Ogi:
groin	gr\oIn
groom	gr\}:m
groomsman	`gr\}:mzm@n
groove	gr\}:v
grope	gr\@}p
gross	gr\@}s
grotesque	gr\@}`tesk
grotty	`gr\Oti:
grouch	gr\{OtS
ground	gr\{Ond
groundwork	`gr\{Ondw3:k
group	gr\}:p
grout	gr\{Ot
grove	gr\@}v
grovel	`gr\Ov@l
grow	gr\@}
growl	gr\{Ol
grown	gr\@}n
growth	gr\@}T
grub	gr\6b
grubby	`gr\6bi:
grudge	gr\6dZ
grudging	`gr\6dZIN
gruelling	`gr\}:lIN
gruesome	`gr\}:s@m
gruff	gr\6f
grumble	`gr\6mb@l
grumpy	`gr\6mpi:
grunt	gr\6nt
guarantee	g{r\@n`ti:
guard	g6:d
guardian	`g6:di:@n
guerilla	g@`r\Il@
guess	ges
guest	gest
guffaw	g6`fo:
guidance	`gAed@ns
guide	gAed
guile	gAel
guilt	gIlt
guitar	g@`t6:
gulf	g6lf
gullet	`g6l@t
gullible	`g6l@b@l
gully	`g6li:
gulp	g6lp
gum	g6m
gumboot	`g6mb}:t
gun	g6n
gurgle	`g3:g@l
gush	g6S
gust	g6st
gusto	`g6st@}
gut	g6t
gutter	`g6t@
guy	gAe
guzzle	`g6z@l
gym	dZIm
gymnasium	dZIm`n{Izi:@m
gymnastics	dZIm`n{stIks
gynaecologist	gAen@`kOl@dZ@st
gypsy	`dZIpsi:
H	{ItS
h	{ItS
habit	`h{b@t
habitat	`h{b@t{t
hack	h{k
hacksaw	`h{kso:
had	h{d
hade	h{Id
hadnt	`h{d@nt
haemoglobin	hi:m@`gl@}b@n
haemophilia	hi:m@`fIli:@
haemorrhage	`hem@r\IdZ
haemorrhoid	`hem@r\oId
haggard	`h{g@d
haggle	`h{g@l
hah	h6:
hail	h{Il
hair	he:
hair-raising	`he:r\{IzIN
haircut	`he:k6t
hairdo	`he:d}:
hairdresser	`he:dr\es@
haired	he:d
hairstyle	`he:stAel
Hal	h{l
half	h6:f
half-brother	`h6:fbr\6D@
half-hearted	`h6:fh6:t@d
half-sister	`h6:fsIst@
halfway	`h6:fw{I
hall	ho:l
hallmark	`ho:lm6:k
Halloween	h{l@wi:n
hallucinate	h@`l}:s@n{It
hallway	`ho:lw{I
halo	`h{Il@}
halt	ho:lt
halve	h6:v
ham	h{m
hamburger	`h{mb3:g@
hammer	`h{m@
hammock	`h{m@k
hamper	`h{mp@
hamstring	`h{mstr\IN
han	h{n
hand	h{nd
handbag	`h{ndb{g
handcuffs	`h{ndk6fs
handful	`h{ndfUl
handicap	`h{ndi:k{p
handicraft	`h{ndi:kr\6:ft
handkerchief	`h{Nk@tSi:f
handle	`h{nd@l
handmade	`h{ndm{Id
handout	`h{nd{Ot
hands-on	h{ndz`On
handshake	`h{ndS{Ik
handsome	`h{ns@m
handwriting	`h{ndr\AetIN
handy	`h{ndi:
hane	h{In
hang	h{N
hang-glider	`h{NglAed@
hang-up	`h{N6p
hangar	`h{N@
hanger	`h{N@
hangover	`h{N@}v@
hankie	`h{Nki:
haphazard	h{p`h{z@d
happen	`h{p@n
happy	`h{pi:
harass	h@`r\{s
harbour	`h6:b@
hard	h6:d
hardly	`h6:dli:
hardship	`h6:dSIp
hardware	`h6:dwe:
hardy	`h6:di:
harl	h6:l
harm	h6:m
harmony	`h6:m@ni:
harn	h6:n
harness	`h6:n@s
harp	h6:p
harpoon	h6:`p}:n
harsh	h6:S
harvest	`h6:v@st
has	h{z
hash	h{S
hassle	`h{s@l
haste	h{Ist
hat	h{t
hat-trick	`h{ttr\Ik
hatch	h{tS
hatchback	`h{tSb{k
hatchet	`h{tS@t
hate	h{It
haughty	`ho:ti:
haul	ho:l
haunt	ho:nt
have	h{v
haven	`h{Iv@n
havoc	`h{v@k
hawk	ho:k
hay	h{I
haywire	`h{IwAe@
hazard	`h{z@d
haze	h{Iz
hazel	`h{Iz@l
he	hi:
he'd	hi:d
head	hed
head-on	hed`On
headache	`hed{Ik
heading	`hedIN
headland	`hedl{nd
headlight	`hedlAet
headline	`hedlAen
headquarters	`hedkwo:t@z
headstone	`hedst@}n
headstrong	`hedstr\ON
headteacher	`hedti:tS@
headway	`hedw{I
headwind	`hedwInd
heal	hi:l
health	helT
heap	hi:p
hear	hI@
heared	hI@d
hearing	`hI@r\IN
hearsay	`hI@s{I
hearse	h3:s
heart	h6:t
heartache	`h6:t{Ik
heartbreak	`h6:tbr\{Ik
heartburn	`h6:tb3:n
hearten	`h6:t@n
heartless	`h6:tl@s
hearty	`h6:ti:
heat	hi:t
heater	`hi:t@
heathen	hi:D@n
heatwave	`hi:tw{Iv
heave	hi:v
heaven	`hev@n
heavy	`hevi:
heckle	`hek@l
hectare	`hekte:
hectic	`hektIk
hedge	hedZ
heed	hi:d
heel	hi:l
heen	hi:n
hefty	`hefti:
heifer	`hef@
height	hAet
heighten	`hAet@n
heights	hAets
heir	e:
heirloom	`e:l}:m
held	held
Helen	hel@n
helicopter	`heli:kOpt@
heliport	`heli:po:t
hell	hel
hello	h6`l@}
helm	helm
helmet	`helm@t
help	help
helping	`helpIN
helpless	`helpl@s
hem	hem
hemisphere	`hem@sfI@
hemline	`hemlAen
hemp	hemp
hen	hen
hence	hens
henceforth	hens`fo:T
hepatitis	hep@`tAet@s
her	h3:
herald	`her\@ld
herb	h3:b
herd	h3:d
here	hI@
heredity	h@`r\ed@ti:
heresy	`her\@si:
heritage	`her\@tIdZ
hermit	`h3:m@t
hernia	`h3:ni:@
hero	`hI@r\@}
heroin	`her\@w@n
heroine	`her\@w@n
herpes	`h3:pi:z
hers	h3:z
herself	h@`self
hesitate	`hez@t{It
het	het
heterosexual	het@r\@`sekS}:@l
hew	hj}:
heyday	`h{Id{I
hi	hAe
hi-fi	`hAefAe
hibernate	`hAeb@n{It
hiccup	`hIk6p
hid	hId
hidden	`hId@n
hide	hAed
hideaway	`hAed@w{I
hideous	`hIdi:@s
hierarchy	`hAe@r\6:ki:
high	hAe
highbrow	`hAebr\{O
highland	`hAel@nd
highlight	`hAelAet
highlighter	`hAelAet@
highly	`hAeli:
highway	`hAew{I
hijack	`hAedZ{k
hike	hAek
hilarious	h@`le:r\i:@s
hile	hAel
hill	hIl
hilt	hIlt
him	hIm
himself	hIm`self
hin	hIn
hind	hAend
hinder	`hInd@
hindsight	`hAendsAet
Hinduism	`hInd}:Iz@m
hine	hAen
hinge	hIndZ
hinges	hIndZ@z
hint	hInt
hip	hIp
hire	`hAe@
hire-purchase	hAe@`p3:tS@s
his	hIz
hiss	hIs
historic	hI`stOr\Ik
historical	hI`stOr\Ik@l
history	`hIstr\i:
hit	hIt
hit-and-run	hIt@n`r\6n
hitch	hItS
hitchhike	`hItShAek
hitherto	hID@`t}:
hive	hAev
hoard	ho:d
hoarding	`ho:dIN
hoarse	ho:s
hoax	h@}ks
hobble	`hOb@l
hobby	`hObi:
hobbyhorse	`hObi:ho:s
hockey	`hOki:
hod	hOd
hode	h@}d
hoe	h@}
hog	hOg
hoil	hoIl
hoin	hoIn
hoist	hoIst
hoit	hoIt
hold	h@}ld
hold-up	`h@}ld6p
hole	h@}l
holiday	`hOl@d{I
holl	hOl
hollow	`hOl@}
holocaust	`hOl@kOst
hologram	`hOl@gr\{m
holster	`h@}lst@
holy	`h@}li:
homage	`hOmIdZ
home	h@}m
homeland	`h@}ml{nd
homesick	`h@}msIk
homestead	`h@}msted
homework	`h@}mw3:k
homicide	`hOm@sAed
homoeopathy	h@}mi:`Op@Ti:
homogeneous	h@}m@`dZi:ni:@s
homosexual	h@}m@}`sekS}:@l
hon	hOn
hone	h@}n
honest	`On@st
honey	`h6ni:
honeycomb	`h6ni:k@}m
honeymoon	`h6ni:m}:n
honorary	`On@r\@r\i:
honour	`On@
honourable	`On@r\@b@l
hood	hUd
hoodlum	`h}:dl@m
hoodwink	`hUdwINk
hoof	hUf
hook	hUk
hool	h}:l
hooligan	`h}:li:g@n
hooll	hUl
hoon	h}:n
hoop	h}:p
hoot	h}:t
hoott	hUt
hop	hOp
hope	h@}p
hopeful	`h@}pfUl
hopeless	`h@}pl@s
horde	ho:d
hore	ho:
horizon	h@`r\Aez@n
horizontal	hOr\@`zOnt@l
hormone	`ho:m@}n
horn	ho:n
horoscope	`hOr\@sk@}p
horrendous	h@`r\end@s
horrible	`hOr\@b@l
horrify	`hOr\@fAe
horror	`hOr\@
horse	ho:s
horseshoe	`ho:sS}:
hort	ho:t
horticulture	`ho:t@k6ltS@
hose	h@}z
hosiery	`h@}Z@r\i:
hospice	`hOsp@s
hospital	`hOsp@t@l
hospitality	hOsp@`t{l@ti:
host	h@}st
hostage	`hOstIdZ
hostel	`hOstel
hostile	`hOstAel
hot	hOt
hote	h@}t
hotel	h@}`tel
hothouse	`hOth{Os
hotline	`hOtlAen
hotplate	`hOtpl{It
hound	h{Ond
hour	{O@
house	h{Os
house-warming	`h{Oswo:mIN
housebreaker	`h{Osbr\{Ik@
household	`h{Osh@}ld
housekeeping	`h{Oski:pIN
housewife	`h{OswAef
housework	`h{Osw3:k
hovel	`hOv@l
hover	`hOv@
hovercraft	`hOv@kr\6:ft
hovered	hOv@d
how	h{O
howd	h{Od
however	h{O`ev@
howl	h{Ol
hown	h{On
howt	h{Ot
hoy	hoI
hoyd	hoId
HQ	{ItS`kj}:
hr	{O@
HSC	{ItSes`si:
ht	hAet
hub	h6b
hud	h6d
huddle	`h6d@l
hue	hj}:
hug	h6g
huge	hj}:dZ
hulk	h6lk
hull	h6l
hullo	`h6l@}
hum	h6m
human	`hj}:m@n
humane	hj}:`m{In
humanitarian	hj}:m{n@`te:r\i:@n
humanity	hj}:`m{n@ti:
humble	`h6mb@l
humdrum	`h6mdr\6m
humid	`hj}:m@d
humiliate	hj}:`mIli:{It
humility	hj}:`mIl@ti:
humour	`hj}:m@
hump	h6mp
humpy	`h6mpi:
hun	h6n
hunch	h6ntS
hundred	`h6ndr\@d
hung	h6N
Hungarian	h6N`ge:r\i:@n
hunger	`h6Ng@
hunt	h6nt
hunter	h6nt@
hurdle	`h3:d@l
hurl	h3:l
hurled	h3:ld
hurn	h3:n
hurrah	h@r\6:
hurray	h@`r\{I
hurricane	`h6r\@k{In
hurry	`h6r\i:
hurt	h3:t
hurtful	`h3:tfUl
hurtle	`h3:t@l
husband	`h6zb@nd
hush	h6S
husk	h6sk
husky	`h6ski:
hustle	`h6s@l
hut	h6t
hutch	h6tS
hwy	`hAew{I
hybrid	`hAebr\@d
hydrant	`hAedr\@nt
hydraulic	hAe`dr\OlIk
hydro-electric	hAedr\@}@`lektr\Ik
hydrofoil	`hAedr\@foIl
hydroponics	hAedr\@`pOnIks
hygiene	`hAedZi:n
hymn	hIm
hype	hAep
hyped-up	`hAept6p
hyphen	`hAef@n
hypnosis	hIp`n@}s@s
hypochondriac	hAep@`kOndr\i:{k
hypocrite	`hIp@kr\It
hypodermic	hAep@`d3:mIk
hypothesis	hAe`pOT@s@s
hysterectomy	hIst@`r\ekt@mi:
hysteria	hIs`tI@r\i:@
I	Ae
i	Ae
I	Ae
i.e.	Ae`i:
I'll	Ael
I've	Aev
ice	Aes
ice-cream	`Aeskr\i:m
iceberg	`Aesb3:g
icicle	`AesIk@l
icing	`AesIN
ID	Ae`di:
idea	Ae`dI@
ideal	Ae`di:l
identical	Ae`dentIk@l
identification	Aedent@f@`k{IS@n
identify	Ae`dent@fAe
identity	Ae`dent@ti:
idiom	`Idi:@m
idiot	`Idi:@t
idle	`Aed@l
idol	`Aed@l
if	If
ignite	Ig`nAet
ignition	Ig`nIS@n
ignorant	`Ign@r\@nt
ignore	Ig`no:
ill	Il
illegal	I`li:g@l
illegible	I`ledZ@b@l
illegitimate	Il@`dZIt@m@t
illicit	I`lIs@t
illiterate	I`lIt@r\@t
illuminate	@`l}:m@n{It
illusion	@`l}:Z@n
illustrate	`Il@str\{It
image	`ImIdZ
imaginary	@`m{dZ@nr\i:
imagination	@m{dZ@`n{IS@n
imagine	@`m{dZ@n
imam	`Im6:m
imbecile	`Imb@si:l
imitate	`Im@t{It
immaculate	@`m{kj@l@t
immature	`Im@tSU@
immediate	@`mi:di:@t
immense	@`mens
immerse	@`m3:s
immigrant	`Im@gr\@nt
imminent	`Im@n@nt
immoral	I`mOr\@l
immortal	I`mo:t@l
immune	@`mj}:n
impact	`Imp{kt
impair	Im`pe:
impartial	Im`p6:S@l
impatient	Im`p{IS@nt
impede	Im`pi:d
imperative	Im`per\@tIv
imperfect	Im`p3:fekt
imperial	Im`pI@r\i:@l
impersonal	Im`p3:s@n@l
impersonate	Im`p3:s@n{It
impertinent	Im`p3:t@n@nt
impetuous	Im`petj}:@s
implement	`Impl@m@nt
implicate	`Impl@k{It
implication	Impl@`k{IS@n
implicit	Im`plIs@t
implore	Im`plo:
imply	Im`plAe
impolite	Imp@`lAet
import	Im`po:t
important	Im`po:t@nt
impose	Im`p@}z
imposing	Im`p@}zIN
impossible	Im`pOs@b@l
imposter	Im`pOst@
impotent	`Imp@t@nt
impress	Im`pr\es
impression	Im`pr\eS@n
imprison	Im`pr\Iz@n
improve	Im`pr\}:v
impudent	`Impj@d@nt
impulse	`Imp6ls
impure	Im`pjU@
in	In
in-	In
in-laws	`Inlo:z
in-patient	`Inp{IS@nt
inaccurate	I`n{kj@r\@t
inadequate	I`n{d@kw@t
inane	I`n{In
inanimate	I`n{n@m@t
inappropriate	In@`pr\@}pr\i:@t
incapacitate	Ink@`p{s@t{It
incentive	In`sentIv
incessant	In`ses@nt
incest	`Insest
inch	IntS
incidence	`Ins@d@ns
incident	`Ins@d@nt
incidental	Ins@`dent@l
incinerate	In`sIn@r\{It
incite	In`sAet
incline	`INklAen
inclined	IN`klAend
include	IN`kl}:d
inclusive	IN`kl}:sIv
incoherent	INk@}`hI@r\@nt
income	`Ink6m
incoming	`Ink6mIN
incompetent	IN`kOmp@t@nt
inconvenient	INk@n`vi:ni:@nt
incorporate	IN`ko:p@r\{It
increase	IN`kr\i:s
increased	INkr\i:st
incredible	IN`kr\ed@b@l
incur	IN`k3:
indebted	In`det@d
indecent	In`di:s@nt
indeed	In`di:d
indefinite	In`def@n@t
indent	In`dent
independent	Ind@`pend@nt
index	`Indeks
indicate	`Ind@k{It
indicator	`Ind@k{It@
indifferent	In`dIfr\@nt
indigenous	In`dIdZ@n@s
indigestion	Ind@`dZestS@n
indignant	In`dIgn@nt
indispensable	Ind@s`pens@b@l
indisposed	Ind@s`p@}zd
indisputable	Ind@s`pj}:t@b@l
individual	Ind@`vIdZ}:@l
indoctrinate	In`dOktr\@n{It
indolent	`Ind@l@nt
Indonesian	Ind@`ni:Z@n
indoors	In`do:z
induce	In`dj}:s
indulge	In`d6ldZ
industry	`Ind@str\i:
inept	In`ept
inevitable	In`ev@t@b@l
inevitably	In`ev@t@bli:
inexperience	In@k`spI@r\i:@ns
infamous	`Inf@m@s
infant	`Inf@nt
infatuated	In`f{tS}:{It@d
infection	In`fekS@n
infectious	In`fekS@s
infer	In`f3:
inferior	In`fI@r\i:@
infest	In`fest
infidelity	Inf@`del@ti:
infiltrate	`Inf@ltr\{It
infinite	`Inf@n@t
infinitive	In`fIn@tIv
inflame	In`fl{Im
inflammable	In`fl{m@b@l
inflate	In`fl{It
inflation	In`fl{IS@n
inflect	In`flekt
inflexible	In`fleks@b@l
inflict	In`flIkt
influence	`Infl}:@ns
influenza	Infl}:`enz@
influx	`Infl6ks
inform	In`fo:m
informal	In`fo:m@l
information	Inf@`m{IS@n
infuriate	In`fj}:r\i:{It
ingenious	In`dZi:ni:@s
ingrained	`Ingr\{Ind
ingratiate	In`gr\{ISi:{It
ingratitude	In`gr\{t@tS}:d
ingredient	In`gr\i:di:@nt
inhabit	In`h{b@t
inhale	In`h{Il
inherit	In`her\@t
initial	@`nIS@l
initiate	@`nISi:{It
initiative	@`nIS@tIv
inject	In`dZekt
injure	`IndZ@
injustice	In`dZ6st@s
ink	INk
inkling	`INklIN
inlaid	`Inl{Id
inland	`Inl{nd
inmate	`Inm{It
inner	`In@
innings	`InINz
innocent	`In@s@nt
innumerable	I`nj}:m@r\@b@l
inoculate	I`nOkj@l{It
inquest	`INkwest
inquire	IN`kwAe@
inquisitive	IN`kwIz@tIv
insane	In`s{In
insect	`Insekt
insecticide	In`sekt@sAed
insecure	Ins@`kj}:@
insensitive	In`sens@tIv
insert	In`s3:t
inside	In`sAed
insinuate	In`sInj}:{It
insipid	In`sIp@d
insist	In`sIst
insolent	`Ins@l@nt
inspect	In`spekt
inspire	In`spAe@
install	In`sto:l
instalment	In`sto:lm@nt
instance	`Inst@ns
instant	`Inst@nt
instead	In`sted
instinct	`InstINkt
institute	`Inst@tS}:t
institution	Inst@`tj}:S@n
instruct	In`str\6kt
instruction	In`str\6kS@n
instrument	`Instr\@m@nt
insubordinate	Ins@`bo:d@n@t
insubstantial	Ins@b`st{nS@l
insufferable	In`s6f@r\@b@l
insulate	`InS@l{It
insulin	`InS@l@n
insult	In`s6lt
insure	In`So:
intact	In`t{kt
integral	`Int@gr\@l
integrate	`Int@gr\{It
integrity	In`tegr\@ti:
intellect	`Int@lekt
intelligence	In`tel@dZ@ns
intelligent	In`tel@dZ@nt
intend	In`tend
intense	In`tens
intensive	In`tensIv
intention	In`tenS@n
interact	Int@r\`{kt
intercept	Int@`sept
intercourse	`Int@ko:s
interest	`Intr\@st
interesting	`Intr\@stIN
interfere	Int@`fI@
interim	`Int@r\@m
interior	In`tI@r\i:@
interjection	Int@`dZekS@n
interlude	`Int@l}:d
intermediate	Int@`mi:di:@t
intermission	Int@`mIS@n
intermittent	Int@`mIt@nt
internal	In`t3:n@l
international	Int@`n{S@n@l
interpret	In`t3:pr\@t
interrogate	In`ter\@g{It
interrogative	Int@`r\Og@tIv
interrupt	Int@`r\6pt
intersection	`Int@`sekS@n
interstate	`Int@st{It
interval	`Int@v@l
intervene	Int@`vi:n
interview	`Int@vj}:
intestine	In`test@n
intimate	`Int@m@t
intimidate	In`tIm@d{It
into	`Int}:
intonation	Int@`n{IS@n
intoxicated	In`tOks@k{It@d
intransitive	In`tr\{nz@tIv
intravenous	Intr\@`vi:n@s
intrigue	In`tr\i:g
introduce	Intr\@`dj}:s
introduction	Intr\@`d6kS@n
intrude	In`tr\}:d
intuition	IntS}:`IS@n
invade	In`v{Id
invalid	In`v{l@d
invaluable	In`v{lj@b@l
invent	In`vent
invest	In`vest
investigate	In`vest@g{It
invigorate	In`vIg@r\{It
invisible	In`vIz@b@l
invite	In`vAet
invoice	`InvoIs
involve	In`vOlv
involved	In`vOlvd
IOU	Ae@}`j}:
irate	Ae`r\{It
iris	`Aer\@s
irk	3:k
iron	`Ae@n
irony	`Aer\@ni:
irrational	I`r\{S@n@l
irregular	I`r\egj@l@
irrelevant	I`r\el@v@nt
irrigate	`Ir\@g{It
irritate	`Ir\@t{It
is	Iz
Islam	`Izl{m
island	`Ael@nd
isn't	Iz@nt
isolate	`Aes@l{It
issue	`IS}:
it	It
it's	Its
Italian	@`t{lj@n
italics	I`t{lIks
itch	ItS
itches	ItS@z
item	`Aet@m
itinerary	Ae`tIn@r\i:
its	Its
itself	It`self
Ive	Aev
ivy	`Aevi:
J	dZ{I
j	dZ{I
jab	dZ{b
jabber	`dZ{b@
jabiru	dZ{b@`r\}:
jack	dZ{k
jackeroo	dZ{k@`r\}:
jacket	`dZ{k@t
jackknife	`dZ{knAef
jackpot	`dZ{kpOt
jade	dZ{Id
jaded	`dZ{Id@d
jagged	`dZ{g@d
jail	dZ{Il
jam	dZ{m
jamb	dZ{m
Jan.	`dZ{nj@r\i:
jangle	`dZ{Ng@l
January	`dZ{nj@r\i:
Japanese	dZ{p@`ni:z
jar	dZ6:
jargon	`dZ6:g@n
jarrah	`dZ{r\@
jaundice	`dZo:nd@s
jaunt	dZo:nt
jaunty	`dZo:nti:
javelin	`dZ{v@l@n
jaw	dZo:
jaywalk	`dZ{Iwo:k
jazz	dZ{z
jealous	`dZel@s
jeans	dZi:nz
jeep	dZi:p
jeer	dZI@
Jeff's	dZefs
jelly	`dZeli:
jellyfish	`dZeli:fIS
jeopardy	`dZep@di:
jerk	dZ3:k
jersey	`dZ3:zi:
jet	dZet
jettison	`dZet@s@n
jetty	`dZeti:
jewel	`dZ}:@l
jewellery	`dZ}:@lr\i:
Jewish	`dZ}:IS
jibe	dZAeb
jiffy	`dZIfi:
jig	dZIg
jiggle	`dZIg@l
jigsaw	`dZIgso:
jillaroo	`dZIl@r\}:
jilt	dZIlt
jingle	`dZINg@l
jinx	dZINks
jitters	`dZIt@z
jive	dZAev
jnr	`dZ}:nj@
job	dZOb
jobless	`dZObl@s
jockey	`dZOki:
jocular	`dZOkj@l@
jodhpurs	`dZOdp@z
joey	`dZ@}i:
jog	dZOg
John	dZOn
join	dZoIn
joiner	`dZoIn@
joint	dZoInt
joist	dZoIst
joke	dZ@}k
joker	`dZ@}k@
jokes	dZ@}ks
jolly	`dZOli:
jolt	dZ@}lt
jostle	`dZOs@l
jot	dZOt
jotter	`dZOt@
joule	dZ}:l
journal	`dZ3:n@l
journalist	`dZ3:n@l@st
journey	`dZ3:ni:
jovial	`dZ@}vi:@l
joy	dZoI
JP	dZ{I`pi:
jube	dZ}:b
jubilant	`dZ}:b@l@nt
jubilee	dZ}:b@`li:
Judaism	`dZ}:d{IIz@m
judge	dZ6dZ
judgment	`dZ6dZm@nt
judicial	dZ}:`dIS@l
judicious	dZ}:`dIS@s
Judith	dZ}:d@T
judo	`dZ}:d@}
jug	dZ6g
juggle	`dZ6g@l
juice	dZ}:s
jukebox	`dZ}:kbOks
Jul.	dZ@`lAe
July	dZ@`lAe
jumble	`dZ6mb@l
jumbo	`dZ6mb@}
jumbuck	`dZ6mb6k
jump	dZ6mp
jumper	`dZ6mp@
jumpy	`dZ6mpi:
Jun.	dZ}:n
junction	`dZ6NkS@n
juncture	`dZ6NktS@
June	dZ}:n
jungle	`dZ6Ng@l
junior	`dZ}:nj@
junk	dZ6Nk
junkie	`dZ6Nki:
junta	`dZ6nt@
jurisdiction	dZ}:r\@s`dIkS@n
jury	`dZ}:r\i:
just	dZ6st
justice	`dZ6st@s
justify	`dZ6st@fAe
jut	dZ6t
jute	dZ}:t
juvenile	`dZ}:v@nAel
juxtapose	dZ6kst@`p@}z
K	k{I
k	k{I
kaleidoscope	k@`lAed@sk@}p
kangaroo	k{Ng@`r\}:
karate	k@`r\6:ti:
kayak	`kAe{k
kazoo	k@z}:
kebab	k@`b{b
keel	ki:l
keen	ki:n
keep	ki:p
keeper	`ki:p@
keeping	`ki:pIN
keepsake	`ki:ps{Ik
keg	keg
kelp	kelp
kennel	`ken@l
kept	kept
kerb	k3:b
kernel	`k3:n@l
kero	`ker\@}
kerosene	ker\@`si:n
ketchup	`ketS@p
kettle	`ket@l
key	ki:
keyboard	`ki:bo:d
keynote	`ki:n@}t
kg	k{I`dZi:
khaki	k6:`ki:
Khmer	k@`me:
kibble	`kIb@l
kick	kIk
kid	kId
kidnap	`kIdn{p
kidney	`kIdni:
kill	kIl
killing	`kIlIN
kiln	kIln
kilo	`ki:l@}
kilobyte	`kIl@bAet
kilogram	`kIl@gr\{m
kilohertz	`kIl@h3:ts
kilojoule	`kIl@dZ}:l
kilometre	k@`lOm@t@
kilowatt	`kIl@wOt
kilt	kIlt
kimono	`kIm@n@}
kin	kIn
kind	kAend
kindergarten	`kInd@g6:t@n
kindle	`kInd@l
kindling	`kIndlIN
kindly	`kAendli:
kindred	`kIndr\@d
kindy	`kIndi:
king	kIN
kingdom	`kINd@m
kink	kINk
kinship	`kInSIp
kiosk	`ki:Osk
kiss	kIs
kit	kIt
kitchen	`kItS@n
kitchenette	kItS@`net
kite	kAet
kitsch	kItS
kitten	`kIt@n
kiwi	`ki:wi:
kJ	`kIl@dZ}:l
kleptomania	klept@`m{Ini:@
km	k@`lOm@t@
knack	n{k
knackered	`n{k@d
knapsack	`n{ps{k
knave	n{Iv
knead	ni:d
knee	ni:
kneecap	`ni:k{p
kneel	ni:l
knew	nj}:
knick-knack	`nIkn{k
knickers	`nIk@z
knife	nAef
knight	nAet
knit	nIt
knitting	`nItIN
knob	nOb
knock	nOk
knot	nOt
know	n@}
knowing	`n@}IN
knowledge	`nOlIdZ
known	n@}n
knuckle	`n6k@l
KO	k{I`@}
koala	k@}`6:l@
kookaburra	`kUk@b6r\@
Korean	k@`r\i:@n
kosher	`k@}S@
kung-fu	k6N`f}:
L	el
l	el
L-plate	`elpl{It
La	l{In
label	`l{Ib@l
Labor	`l{Ib@
laboratory	l@`bOr\@tr\i:
labour	`l{Ib@
lace	l{Is
lacerate	`l{s@r\{It
lack	l{k
lacquer	`l{k@
lad	l{d
ladder	`l{d@
lady	`l{Idi:
lag	l{g
lager	`l6:g@
lagoon	l@`g}:n
laid	l{Id
lake	l{Ik
lamb	l{m
lame	l{Im
laminate	`l{m@n{It
lamington	`l{mINt@n
land	l{nd
landed	l{nd@d
landlady	`l{ndl{Idi:
landlord	`l{ndlo:d
landmark	`l{ndm6:k
landscape	`l{ndsk{Ip
landslide	`l{ndslAed
lane	l{In
language	`l{NgwIdZ
lank	l{Nk
lanky	`l{Nki:
lantern	`l{nt@n
Lao	l{O
lap	l{p
lapse	l{ps
large	l6:dZ
larrikin	`l{r\@k@n
laryngitis	l{r\@n`dZAet@s
larynx	`l{r\INks
laser	`l{Iz@
lash	l{S
last	l6:st
latch	l{tS
late	l{It
lately	`l{Itli:
later	`l{It@
latest	`l{It@st
lather	`l{D@
Latin	`l{t@n
latitude	`l{t@tS}:d
latter	`l{t@
lattice	`l{t@s
laugh	l6:f
launch	lo:ntS
laundromat	`lo:ndr\@m{t
laundry	`lo:ndr\i:
lavatory	`l{v@tr\i:
lavender	`l{v@nd@
lavish	`l{vIS
law	lo:
lawful	`lo:f@l
lawn	lo:n
lawnmower	`lo:nm@}@
lawyer	`loI@
lax	l{ks
laxative	`l{ks@tIv
lay	l{I
lay-by	`l{IbAe
layer	`l{I@
layout	`l{I{Ot
lazy	`l{Izi:
lead	li:d
leader	`li:d@
leaf	li:f
league	li:g
leak	li:k
lean	li:n
leant	lent
leap	li:p
leapt	lept
learn	l3:n
lease	li:s
leash	li:S
least	li:st
leather	`leD@
leave	li:v
lecture	`lektS@
led	led
ledge	ledZ
ledger	`ledZ@
leer	lI@
left	left
left-handed	left`h{nd@d
leg	leg
legal	`li:g@l
legend	`ledZ@nd
leggings	`legINz
legible	`ledZ@b@l
legislation	ledZ@`sl{IS@n
legitimate	l@`dZIt@m@t
leisure	`leZ@
lemon	`lem@n
lemonade	lem@n`{Id
lend	lend
length	leNT
lengthen	`leNT@n
lenient	`li:ni:@nt
lens	lenz
lent	lent
leotard	`li:@t6:d
lesbian	`lezbi:@n
less	les
lessen	`les@n
lesson	`les@n
let	let
let's	lets
lethal	`li:T@l
lethargic	l@T6:dZIk
letter	`let@
leukaemia	l}:`ki:mi:@
level	`lev@l
lever	`li:v@
levy	`levi:
liability	lAe@`bIl@ti:
liable	`lAe@b@l
liaison	li:`{Iz@n
liar	`lAe@
libel	`lAeb@l
liberal	`lIbr\@l
liberate	`lIb@r\{It
liberty	`lIb@ti:
library	`lAebr\i:
lice	lAes
licence	`lAes@ns
lick	lIk
licorice	`lIk@r\IS
lid	lId
lie	lAe
life	lAef
lifelong	`lAeflON
lifesaver	`lAefs{Iv@
lifetime	`lAeftAem
lift	lIft
lifted	lIft@d
light	lAet
lighthouse	lAeth{Os
lightning	`lAetnIN
like	lAek
likely	`lAekli:
limb	lIm
lime	lAem
limelight	`lAemlAet
limestone	`lAemst@}n
limit	`lIm@t
limp	lImp
line	lAen
linen	`lIn@n
liner	`lAen@
linger	`lINg@
lingerie	`lOnZ@r\{I
linguistic	lIN`gwIstIk
liniment	`lIn@m@nt
lining	`lAenIN
link	lINk
linoleum	l@`n@}li:@m
lip	lIp
lipstick	`lIpstIk
liquefy	`lIkw@fAe
liqueur	l@`kj}:@
liquid	`lIkw@d
liquidate	`lIkw@d{It
liquor	`lIk@
lisp	lIsp
list	lIst
listen	`lIs@n
listless	`lIstl@s
lit	lIt
literal	`lItr\@l
literary	`lIt@r\@r\i:
literate	`lIt@r\@t
literature	`lItr\@tS@
litre	`li:t@
litter	`lIt@
litterbug	`lIt@b6g
little	`lIt@l
live	lIv
lived	lIvd
livelihood	`lAevli:hUd
lively	`lAevli:
liver	`lIv@
livestock	`lAevstOk
livid	`lIv@d
living	`lIvIN
lizard	`lIz@d
load	l@}d
loaf	l@}f
loam	l@}m
loan	l@}n
loath	l@}T
loathe	l@}D
lob	lOb
lobby	`lObi:
local	`l@}k@l
locate	l@}`k{It
location	l@}k{IS@n
lock	lOk
locker	`lOk@
locket	`lOk@t
locksmith	`lOksmIT
locomotive	l@}k@`m@}tIv
lodge	lOdZ
loft	lOft
lofty	`lOfti:
log	lOg
logical	`lOdZIk@l
loiter	`loIt@
lolly	`lOli:
lone	l@}n
lonely	`l@}nli:
long	lON
longitude	`lONg@tS}:d
look	lUk
looking	lUkIN
lookout	`lUk{Ot
loom	l}:m
loop	l}:p
loophole	`l}:ph@}l
loose	l}:s
loot	l}:t
lop	lOp
lopsided	lOp`sAed@d
lord	lo:d
lore	lo:
lorry	`lOr\i:
lose	l}:z
loss	lOs
lost	lOst
lot	lOt
lotion	`l@}S@n
lottery	`lOt@r\i:
lotto	`lOt@}
loud	l{Od
loudspeaker	l{Od`spi:k@
lounge	l{OndZ
louse	l{Os
lousy	`l{Ozi:
lout	l{Ot
love	l6v
lovely	`l6vli:
low	l@}
lower	`l@}@
loyal	`loI@l
lozenge	`lOz@ndZ
LPG	elpi:`dZi:
Ltd	`lIm@t@d
lubricate	`l}:br\@k{It
lucid	`l}:s@d
luck	l6k
lucrative	`l}:kr\@tIv
ludicrous	`l}:d@kr\@s
lug	l6g
luggage	`l6gIdZ
lukewarm	l}:k`wo:m
lull	l6l
lullaby	`l6l@bAe
luminous	`l}:m@n@s
lump	l6mp
lunar	`l}:n@
lunatic	`l}:n@tIk
lunch	l6ntS
lung	l6N
lunge	l6ndZ
lurch	l3:tS
lure	l}:@
lurgy	`l3:gi:
lurid	`l}:r\@d
lurk	l3:k
luscious	`l6S@s
lush	l6S
lust	l6st
luxuriant	l6g`Z}:r\i:@nt
luxury	`l6kS@r\i:
lying	lAeIN
lyrebird	`lAe@b3:d
M	em
m	em
macabre	m@`k6:b
macadamia	m{k@`d{Imi:@
macaroni	m{k@`r\@}ni:
Macedonian	m{s@`d@}ni:@n
machete	m@`Seti:
machine	m@`Si:n
machinery	m@`Si:n@r\i:
macho	`m{tS@}
mad	m{d
madam	`m{d@m
made	m{Id
magazine	m{g@`zi:n
maggot	`m{g@t
magic	`m{dZIk
magistrate	`m{dZ@str\{It
magnanimous	m{g`n{n@m@s
magnate	`m{gn{It
magnet	`m{gn@t
magnificent	m{g`nIf@s@nt
magnify	`m{gn@fAe
magnitude	`m{gn@tS}:d
magpie	`m{gpAe
maiden	`m{Id@n
mail	m{Il
maim	m{Im
main	m{In
mainland	`m{Inl{nd
mainstream	`m{Instr\i:m
maintain	m{In`t{In
maize	m{Iz
majesty	`m{dZ@sti:
major	`m{IdZ@
majority	m@`dZOr\@ti:
make	m{Ik
make-believe	`m{Ikb@li:v
make-up	`m{Ik6p
Mal	m{l
maladjusted	m{l@`dZ6st@d
malaria	m@`le:r\i:@
Malcolm	m{lk@m
male	m{Il
malevolent	m@`lev@l@nt
malformation	m{lfo:`m{IS@n
malice	`m{l@s
malign	m@`lAen
malignant	m@`lIgn@nt
malinger	m@`lINg@
mall	mo:l
malleable	`m{li:@b@l
mallee	`m{li:
mallet	`m{l@t
mallow	m{l@}
malnourished	`m{ln6r\ISt
malpractice	m{l`pr\{kt@s
malt	mOlt
maltreat	m{l`tr\i:t
mammal	`m{m@l
mammoth	`m{m@T
man	m{n
manage	`m{nIdZ
management	`m{nIdZm@nt
manager	`m{n@dZ@
manchester	`m{ntSest@
mandarin	`m{nd@r\@n
mandate	`m{nd{It
mandatory	`m{nd@tr\i:
mane	m{In
mange	m{IndZ
mangle	`m{Ng@l
mangrove	`m{Ngr\@}v
mania	`m{Ini:@
maniac	`m{Ini:{k
manicure	`m{n@kjU@
manifest	`m{n@fest
manifesto	m{n@`fest@}
manipulate	m@`nIpj@l{It
mankind	m{n`kAend
manly	`m{nli:
manner	`m{n@
mannerism	`m{n@r\Iz@m
manoeuvre	m@`n}:v@
manor	m{n@
mansion	`m{nS@n
manslaughter	`m{nslo:t@
manta	m{nt@
mantlepiece	`m{nt@lpi:s
manual	`m{nj}:@l
manufacture	m{nj@`f{ktS@
manure	m@`njU@
manuscript	`m{nj@skr\Ipt
manuscripts	m{nj@skr\Ipts
many	`meni:
map	m{p
marathon	`m{r\@TOn
marble	`m6:b@l
march	m6:tS
mare	me:
margarine	m6:dZ@`r\i:n
margin	`m6:dZ@n
marginal	`m6:dZ@n@l
marijuana	m{r\@`w6:n@
marina	m@`r\i:n@
marinate	`m{r\@n{It
marine	m@`r\i:n
marital	`m{r\@t@l
maritime	`m{r\@tAem
mark	m6:k
mark-up	`m6:k6p
market	`m6:k@t
marketing	`m6:k@tIN
marmalade	`m6:m@l{Id
maroon	m@`r\}:n
marquee	m6:`ki:
marriage	`m{r\IdZ
married	`m{r\i:d
marrow	`m{r\@}
marry	`m{r\i:
marsh	m6:S
marshal	`m6:S@l
marshmallow	m6:S`m{l@}
marsupial	m6:`sj}:pi:@l
martyr	`m6:t@
marvel	`m6:v@l
mascara	m{s`k6:r\@
mascot	`m{skOt
masculine	`m{skj@l@n
mash	m{S
mask	m6:sk
mason	`m{Is@n
masonry	`m{Is@nr\i:
masquerade	m{sk@`r\{Id
mass	m{s
massacre	`m{s@k@
massage	`m{s6:Z
massive	`m{sIv
mast	m6:st
mastectomy	m{s`tekt@mi:
master	`m6:st@
masterpiece	`m6:st@pi:s
masturbate	`m{st@b{It
mat	m{t
match	m{tS
mate	m{It
material	m@`tI@r\i:@l
materialise	m@`tI@r\i:@lAez
materialistic	m@tI@r\i:@`lIstIk
maternal	m@`t3:n@l
maternity	m@`t3:n@ti:
mathematics	m{T@`m{tIks
maths	m{Ts
matriarch	`m{Itr\i:6:k
matrimony	`m{tr\@m@ni:
matt	m{t
matter	`m{t@
mattress	`m{tr\@s
mature	m@`tSU@
maul	mo:l
mauve	m@}v
maverick	`m{v@r\Ik
maxim	`m{ks@m
maximum	`m{ks@m@m
May	m{I
may	m{I
maybe	`m{Ibi:
mayonnaise	m{I@`n{Iz
mayor	me:
maze	m{Iz
me	mi:
meagre	`mi:g@
meal	mi:l
mean	mi:n
meander	mi:`{nd@
means	mi:nz
meantime	`mi:ntAem
meanwhile	`mi:nwAel
measles	`mi:z@lz
measure	`meZ@
meat	mi:t
mechanic	m@`k{nIk
mechanical	m@`k{nIk@l
mechanics	m@`k{nIks
mechanise	`mek@nAez
mechanism	`mek@nIz@m
medal	`med@l
medallion	m@`d{lj@n
meddle	`med@l
media	`mi:di:@
median	`mi:di:@n
mediate	`mi:di:{It
medical	`medIk@l
Medicare	`medi:ke:
medicine	`med@s@n
mediocre	mi:di:`@}k@
meditate	`med@t{It
medium	`mi:di:@m
medley	`medli:
meek	mi:k
meet	mi:t
meeting	`mi:tIN
megabyte	`meg@bAet
megaphone	`meg@f@}n
Mel	mel
melancholy	`mel@nkOli:
melanoma	mel@`n@}m@
melba	melb@
Melbourne	melb@n
mellow	`mel@}
melodrama	`mel@dr\6:m@
melody	`mel@di:
melon	`mel@n
melt	melt
Melvin's	melv@nz
member	`memb@
membrane	`membr\{In
memento	m@`ment@}
memo	`mem@}
memoirs	`memw6:z
memorable	`memr\@b@l
memorial	m@`mo:r\i:@l
memorise	`mem@r\Aez
memory	`memr\i:
men	men
menace	`men@s
mend	mend
menial	`mi:ni:@l
menopause	`men@po:z
menstruate	`menstr\}:Aet
mental	`ment@l
mention	`menS@n
menu	`menj}:
mercenary	`m3:s@nr\i:
merchandise	`m3:tS@ndAes
mercury	`m3:kj@r\i:
mercy	`m3:si:
mere	mI@
merge	m3:dZ
meringue	m@`r\{N
merino	m@`r\i:n@}
merit	`mer\@t
mermaid	`m3:m{Id
merry	`mer\i:
merry-go-round	`mer\i:g@}r\{Ond
mesh	meS
mesmerise	`mezm@r\Aez
mess	mes
message	`mesIdZ
messenger	`mes@ndZ@
metabolism	m@`t{b@lIz@m
metal	`met@l
metamorphosis	met@`mo:f@s@s
metaphor	`met@fo:
meteor	`mi:ti:o:
meteorite	`mi:ti:@r\Aet
meteorologist	mi:ti:@`r\Ol@dZ@st
meter	`mi:t@
methadone	`meT@d@}n
methane	mi:T{In
metho	`meT@}
method	`meT@d
methodical	m@`TOdIk@l
methyl	meT@l
meticulous	m@`tIkj@l@s
metre	`mi:t@
metric	`metr\Ik
metropolitan	metr\@`pOl@t@n
mezzanine	`mez@ni:n
mice	mAes
microbe	`mAekr\@}b
microphone	`mAekr\@f@}n
microscope	`mAekr\@sk@}p
mid	mId
midday	`mIdd{I
middle	`mId@l
midget	`mIdZ@t
midnight	`mIdnAet
midriff	`mIdr\If
midwife	`mIdwAef
might	mAet
mighty	`mAeti:
migraine	`mAegr\{In
migrant	`mAegr\@nt
migrate	`mAegr\{It
mild	mAeld
mildew	`mIldj}:
mile	mAel
militant	`mIl@t@nt
military	`mIl@tr\i:
militia	m@`lIS@
milk	mIlk
milkshake	`mIlkS{Ik
mill	mIl
millennium	m@`leni:@m
miller	mIl@
millibar	`mIli:b6:
milligram	`mIl@gr\{m
millilitre	`mIl@li:t@
millimetre	`mIl@mi:t@
milliner	`mIl@n@
million	`mIlj@n
mills	mIlz
mime	mAem
mimic	`mImIk
mince	mIns
mincemeat	`mInsmi:t
mind	mAend
mindful	`mAendf@l
mindless	`mAendl@s
mine	mAen
miner	`mAen@
mineral	`mIn@r\@l
mingle	`mINg@l
miniature	`mIn@tS@
minimal	`mIn@m@l
minimum	`mIn@m@m
minister	`mIn@st@
minor	`mAen@
minority	mAe`nOr\@ti:
mint	mInt
minus	`mAen@s
minute	mAe`nj}:t
miracle	`mIr\@k@l
mirage	m@`r\6:Z
mire	`mAe@
mirror	`mIr\@
mirth	m3:T
misadventure	mIs@d`ventS@
misbehave	mIsb@`h{Iv
miscarriage	mIs`k{r\IdZ
miscellaneous	mIs@`l{Ini:@s
mischief	`mIstS@f
misdemeanour	mIsd@`mi:n@
miser	`mAez@
miserable	`mIzr\@b@l
misery	`mIz@r\i:
misfortune	mIs`fo:tS@n
mishap	`mIsh{p
mislay	mIs`l{I
mislead	mIs`li:d
miss	mIs
missile	`mIsAel
missing	`mIsIN
mission	`mIS@n
missionary	`mIS@nr\i:
mist	mIst
mistake	m@`st{Ik
mistaken	m@`st{Ik@n
mistress	`mIstr\@s
misunderstand	mIs6nd@`st{nd
mitigate	`mIt@g{It
mitten	`mIt@n
mix	mIks
mix-up	`mIks6p
mixed-up	`mIkst6p
mixture	`mIkstS@
mnemonic	n@`mOnIk
moan	m@}n
moat	m@}t
mob	mOb
mobile	`m@}bAel
mobilise	`m@}b@lAez
mock	mOk
modal	`m@}d@l
mode	m@}d
model	`mOd@l
moderate	`mOd@r\@t
modern	`mOd@n
modest	`mOd@st
modify	`mOd@fAe
module	`mOdZ}:l
moist	moIst
molar	`m@}l@
mole	m@}l
molecule	`mOl@kj}:l
molest	m@`lest
molten	`m@}lt@n
moment	`m@}m@nt
momentary	`m@}:m@ntr\i:
momentous	m@`ment@s
monarch	`mOn6:k
monastery	`mOn@str\i:
Monday	`m6nd{I
money	`m6ni:
mongrel	`m6Ngr\@l
monitor	`mOn@t@
monk	m6Nk
monkey	`m6Nki:
mono	`mOn@}
monogamy	m@`nOg@mi:
monogram	`mOn@gr\{m
monolith	`mOn@lIT
monologue	`mOn@lOg
monopoly	m@`nOp@li:
monotonous	m@`nOt@n@s
monotreme	`mOn@tr\i:m
monsoon	mOn`s}:n
monster	`mOnst@
monstrous	`mOnstr\@s
month	m6nT
monument	`mOnj@m@nt
monumental	mOnj@`ment@l
mood	m}:d
moody	`m}:di:
moon	m}:n
moor	mo:
mooring	`mo:r\IN
mop	mOp
mope	m@}p
moral	`mOr\@l
morale	m@`r\6:l
moratorium	mOr\@`to:r\i:@m
morbid	`mo:b@d
more	mo:
moreover	mo:r\`@}v@
morgue	mo:g
mornay	`mo:n{I
morning	`mo:nIN
moron	`mo:r\On
morose	m@`r\@}s
morphine	`mo:fi:n
morsel	`mo:s@l
mortal	`mo:t@l
mortality	mo:`t{l@ti:
mortar	`mo:t@
mortgage	`mo:gIdZ
mortified	`mo:t@fAed
mortuary	`mo:tS@r\i:
mosaic	m@}`z{IIk
mosque	mOsk
moss	mOs
most	m@}st
mostly	`m@}stli:
motel	m@}`tel
mother	`m6D@
mother-in-law	`m6D@r\Inlo:
mother-of-pearl	m6D@r\@v`p3:l
motif	m@}`ti:f
motion	`m@}S@n
motivate	`m@}t@v{It
motive	`m@}tIv
motor	`m@}t@
motorbike	`m@}t@bAek
motorcycle	`m@}t@sAek@l
motorist	`m@}t@r\@st
mottled	`mOt@ld
motto	`mOt@}
mould	m@}ld
moult	m@}lt
mound	m{Ond
mount	m{Ont
mountain	`m{Ont@n
mountaineer	m{Ont@`nI@
mourn	mo:n
mouse	m{Os
mousse	m}:s
moustache	m@`st6:S
mousy	`m{Osi:
mouth	m{OT
mouth-watering	`m{OTwo:t@r\IN
move	m}:v
moved	m}:vd
movement	`m}:vm@nt
movie	`m}:vi:
mow	m@}
mown	m@}n
MP	em`pi:
Mr	`mIst@
Mrs	`mIs@z
MS	em`es
Ms	mIz
MSG	emes`dZi:
much	m6tS
muck	m6k
mucus	`mj}:k@s
mud	m6d
muddle	`m6d@l
mudguard	`m6dg6:d
muesli	`mj}:zli:
muffin	`m6f@n
muffler	`m6fl@
mug	m6g
muggy	`m6gi:
mulch	m6ltS
mulga	`m6lg@
mull	m6l
multicultural	m6lti:`k6ltS@r\@l
multimedia	m6lti:`mi:di:@
multinational	m6lti:`n{S@n@l
multiple	`m6lt@p@l
multiple-choice	`m6lt@p@ltSoIs
multiply	`m6lt@plAe
multiracial	m6lti:`r\{IS@l
multitude	`m6lt@tS}:d
mum	m6m
mumble	`m6mb@l
mummy	`m6mi:
mumps	m6mps
munch	m6ntS
mundane	m6n`d{In
municipality	mj}:nIs@`p{l@ti:
mural	`mj}:r\@l
murder	`m3:d@
murky	`m3:ki:
murmur	`m3:m@
muscle	`m6s@l
museum	mj}:`zi:@m
mush	m6S
mushroom	`m6Sr\}:m
music	`mj}:zIk
musical	`mj}:zIk@l
musk	m6sk
must	m6st
mustard	`m6st@d
muster	`m6st@
musty	`m6sti:
mutate	mj}:`t{It
mute	mj}:t
mutilate	`mj}:t@l{It
mutiny	`mj}:t@ni:
mutter	`m6t@
mutton	`m6t@n
mutual	`mj}:tS}:@l
muzzle	`m6z@l
my	mAe
myopia	mAe`@}pi:@
myriad	`mIr\i:@d
myself	mAe`self
mysterious	m@s`tI@r\i:@s
mystery	`mIstr\i:
mystic	`mIstIk
mystify	`mIst@fAe
myth	mIT
mythology	m@`TOl@dZi:
N	en
n	en
N/A	en`{I
nag	n{g
nail	n{Il
naive	nAe`i:v
naked	`n{Ik@d
name	n{Im
nap	n{p
napkin	`n{pk@n
nappy	`n{pi:
narcotic	n6:`kOtIk
narration	n@`r\{IS@n
narrative	`n{r\@tIv
narrow	`n{r\@}
nasal	`n{Iz@l
nasty	`n6:sti:
nation	`n{IS@n
national	`n{S@n@l
nationalise	`n{S@n@lAez
nationalism	`n{S@n@lIzm
native	`n{ItIv
natter	`n{t@
natty	`n{ti:
natural	`n{tS@r\@l
naturalised	`n{tS@r\@lAezd
nature	`n{ItS@
naughty	`no:ti:
nausea	`no:zi:@
navel	`n{Iv@l
navigate	`n{v@g{It
navy	`n{Ivi:
NB	en`bi:
NE	no:T`i:st
near	nI@
nearby	nI@`bAe
nearer	nI@r\@
nearly	`nI@li:
neat	ni:t
necessary	`nes@ser\i:
neck	nek
necklace	`nekl@s
nee	n{I
need	ni:d
needle	`ni:d@l
negative	`neg@tIv
neglect	n@`glekt
negligee	`negl@Z{I
negligent	`negl@dZ@nt
negligible	`negl@dZ@b@l
negotiable	ne`g@}S@b@l
negotiate	n@`g@}Si:{It
neighbour	`n{Ib@
neither	`nAeD@
nephew	`nefj}:
nerd	n3:d
nerve	n3:v
nervous	`n3:v@s
nest	nest
net	net
netball	`netbo:l
nettle	`net@l
network	`netw3:k
neurotic	nj}:`r\OtIk
neuter	`nj}:t@
neutral	`nj}:tr\@l
never	`nev@
nevertheless	nev@D@`les
new	nj}:
newington	nj}:INt@n
news	nj}:z
newsagent	`nj}:z{IdZ@nt
newspaper	`nj}:zp{Ip@
next	nekst
nib	nIb
nibble	`nIb@l
nice	nAes
niche	ni:S
nick	nIk
nickname	`nIkn{Im
nicotine	nIk@`ti:n
niece	ni:s
nifty	`nIfti:
Nigel	nAedZ@l
night	nAet
nightclothes	`nAetkl@}Dz
nightdress	`nAetdr\es
nightmare	`nAetme:
nightshirt	`nAetS3:t
nil	nIl
nimble	`nImb@l
nine	nAen
nineteen	nAen`ti:n
nineteenth	nAen`ti:nT
ninety	`nAenti:
Ninjas	nIndZ@z
ninth	nAenT
nip	nIp
nippers	`nIp@z
nipple	`nIp@l
nit	nIt
no	n@}
no-one	`n@}w6n
no.	`n6mb@
noble	`n@}b@l
nobody	`n@}bOdi:
nocturnal	nOk`t3:n@l
nod	nOd
nodule	`nOdj}:l
noise	noIz
nominate	`nOm@n{It
nonchalant	`nOnS@l@nt
nondescript	`nOnd@skr\Ipt
none	n6n
nonentity	nOn`ent@ti:
nonetheless	n6nD@`les
nonfiction	nOn`fIkS@n
nonflammable	nOn`fl{m@b@l
nonplussed	nOn`pl6st
nonsense	`nOns@ns
noodle	`n}:d@l
nook	nUk
noon	n}:n
noose	n}:s
nor	no:
normal	`no:m@l
north	no:T
northward	`no:Tw@d
nose	n@}z
nostalgia	nOs`t{ldZ@
nostril	`nOstr\@l
not	nOt
notable	`n@}t@b@l
notch	nOtS
note	n@}t
nothing	`n6TIN
notice	`n@}t@s
notify	`n@}t@fAe
notion	`n@}S@n
notorious	n@`to:r\i:@s
nought	no:t
noun	n{On
nourish	`n6r\IS
Nov.	n@}`vemb@
novel	`nOv@l
novelty	`nOv@lti:
November	n@}`vemb@
now	n{O
noxious	`nOkS@s
nozzle	`nOz@l
NSW	nj}:s{OT`w{Ilz
NT	no:D@n`ter\@tr\i:
nuclear	`nj}:kli:@
nucleus	`nj}:kli:@s
nude	n}:d
nudge	n6dZ
nugget	`n6g@t
nuisance	`nj}:s@ns
numb	n6m
number	`n6mb@
numberplate	`n6mb@pl{It
numeral	`nj}:m@r\@l
numerator	`nj}:m@r\{It@
numerous	`nj}:m@r\@s
nun	n6n
nurse	n3:s
nursery	`n3:s@r\i:
nut	n6t
nutrition	nj}:`tr\IS@n
nutritionist	nj}:`tr\IS@n@st
NW	no:T`west
nylon	`nAelOn
O	@}
o	@}
oaf	@}f
oaks	@}ks
oar	o:
oath	@}T
obedient	@`bi:di:@nt
obese	@}`bi:s
obey	@}`b{I
object	`ObdZekt
objective	@b`dZektIv
oblige	@`blAedZ
oblong	`OblON
obscene	@b`si:n
obscure	@b`skj}:@
observe	@b`z3:v
obsession	@b`seS@n
obsolete	`Obs@li:t
obstacle	`Obst@k@l
obstetrician	Obst@`tr\IS@n
obstinate	`Obst@n@t
obstruct	@b`str\6kt
obtain	@b`t{In
obtuse	@b`tj}:s
obvious	`Obvi:@s
occasion	@`k{IZ@n
occasional	@`k{IZ@n@l
occupation	Okj@`p{IS@n
occupied	`Okj@pAed
occupy	`Okj@pAe
occur	@`k3:
ocean	`@}S@n
oclock	@`klOk
October	Ok`t@}b@
odd	Od
odious	`@}di:@s
odour	`@}d@
of	Ov
off	Of
off-colour	Of`k6l@
off-peak	`Ofpi:k
off-putting	`OfpUtIN
offence	@`fens
offensive	@`fensIv
offer	`Of@
office	`Of@s
officer	`Of@s@
offices	Of@s@z
official	@`fIS@l
often	`Of@n
oh	@}
oil	oIl
ointment	`oIntm@nt
OK	@}`k{I
okay	@}`k{I
old	@}ld
old-fashioned	@}ld`f{S@nd
olive	`OlIv
ombudsman	`Omb@dzm@n
omelette	`Oml@t
omen	`@}m@n
ominous	`Om@n@s
omit	@}`mIt
on	On
once	w6ns
oncoming	`Onk6mIN
one	w6n
onion	6nj@n
only	`@}nli:
onset	`Onset
onto	`Ont@
ooze	}:z
opal	`@}p@l
opaque	@}`p{Ik
open	`@}p@n
open-minded	`@}p@nmAend@d
opera	`Opr\@
operate	`Op@r\{It
ophthalmologist	OfT{l`mOl@dZ@st
opinion	@`pInj@n
opponent	@`p@}n@nt
opportunity	Op@`tj}:n@ti:
oppose	@`p@}z
opposite	`Op@s@t
oppression	@`pr\eS@n
optician	Op`tIS@n
optimism	`Opt@mIz@m
option	`OpS@n
optometrist	Op`tOm@tr\@st
or	o:
oral	`Or\@l
orange	`Or\IndZ
orator	`Or\@t@
orchard	`o:tS@d
orchestra	`o:k@str\@
ordeal	o:`di:l
order	`o:d@
ordinary	`o:d@n@r\i:
organ	`o:g@n
organic	o:`g{nIk
organisation	o:g@nAe`z{IS@n
organise	`o:g@nAez
organism	`o:g@nIz@m
orgasm	`o:g{z@m
orgy	`o:dZi:
oriental	o:r\i:`ent@l
origin	`Or\@dZ@n
original	@`r\IdZ@n@l
originate	@`r\IdZ@n{It
ornament	`o:n@m@nt
orphan	`o:f@n
orthodontist	o:T@`dOnt@st
orthodox	`o:T@dOks
osteopath	`Osti:@p{T
other	`6D@
otherwise	`6D@wAez
ought	o:t
our	{O@
ours	`{O@z
ourselves	{O@`selvz
out	{Ot
outback	`{Otb{k
outbreak	`{Otbr\{Ik
outburst	`{Otb3:st
outcome	`{Otk6m
outcry	`{Otkr\Ae
outdoors	{Ot`do:z
outer	`{Ot@
outfit	`{OtfIt
outgoing	{Ot`g@}IN
outing	`{OtIN
outline	`{OtlAen
outlook	`{OtlUk
outpatient	`{Otp{IS@nt
outrage	{Ot`r\{IdZ
outright	`{Otr\Aet
outset	`{Otset
outside	{Ot`sAed
outskirts	`{Otsk3:ts
outspoken	`{Otsp@}k@n
outstanding	{Ot`st{ndIN
outward	`{Otw@d
outwards	`{Otw@dz
outwit	{Ot`wIt
oval	`@}v@l
ovary	`@}v@r\i:
oven	`6v@n
over	`@}v@
overalls	`@}v@r\o:lz
overarm	`@}v@r\6:m
overawe	@}v@r\`o:
overbalance	@}v@`b{l@ns
overbearing	@}v@`be:r\IN
overboard	`@}v@bo:d
overcast	`@}v@k6:st
overcoat	`@}v@k@}t
overcome	@}v@`k6m
overdo	@}v@`d}:
overdose	`@}v@d@}s
overdraft	`@}v@dr\6:ft
overdue	@}v@`dj}:
overflow	@}v@`fl@}
overhaul	`@}v@ho:l
overhead	@}v@`hed
overhear	@}v@`hI@
overlap	@}v@`l{p
overlook	@}v@`lUk
overnight	@}v@`nAet
overpower	@}v@`p{O@
overrule	@}v@`r\}:l
overseas	@}v@`si:z
oversight	`@}v@sAet
overslept	@}v@slept
overtake	@}v@`t{Ik
overtime	`@}v@tAem
overturn	@}v@`t3:n
overweight	@}v@`w{It
overwhelm	@}v@`welm
overwhelmed	@}v@welmd
overwork	@}v@`w3:k
ovulate	`@vj@l{It
owe	@}
owl	{Ol
own	@}n
oxygen	`Oks@dZ@n
oyster	`oIst@
P	pi:
p	pi:
P-plate	`pi:pl{It
p.a.	p3:r\`{n@m
p.m.	pi:`em
p.t.o.	pi:ti:`@}
PA	pi:`{I
pace	p{Is
pacifist	`p{s@f@st
pacify	`p{s@fAe
pack	p{k
package	`p{kIdZ
packaging	`p{k@dZIN
packed	p{kt
packet	`p{k@t
pact	p{kt
pad	p{d
paddle	`p{d@l
paddock	`p{d@k
padlock	`p{dlOk
paediatrician	pi:di:@`tr\IS@n
page	p{IdZ
paid	p{Id
paid-up	`p{Id6p
pain	p{In
painstaking	`p{Inzt{IkIN
paint	p{Int
painting	`p{IntIN
pair	pe:
pal	p{l
palace	`p{l@s
palate	p{l@t
pale	p{Il
palm	p6:m
palpitate	`p{lp@t{It
paltry	`po:ltr\i:
pamper	`p{mp@
pamphlet	`p{mfl@t
pan	p{n
pancake	`p{Nk{Ik
pancreas	`p{Nkr\i:@s
pand	p{nd
pandemonium	p{nd@`m@}ni:@m
pander	`p{nd@
pane	p{In
panel	`p{n@l
pang	p{N
panic	`p{nIk
panned	p{nd
panorama	p{n@`r\6:m@
pant	p{nt
pantihose	`p{nti:h@}z
pantomime	`p{nt@mAem
pantry	`p{ntr\i:
pants	p{nts
paper	`p{Ip@
paperback	`p{Ip@b{k
par	p6:
parachute	`p{r\@S}:t
parade	p@`r\{Id
paradise	`p{r\@dAes
paradox	`p{r\@dOks
paragraph	`p{r\@gr\{f
parallel	`p{r\@lel
paralyse	`p{r\@lAez
paramedic	p{r\@`medIk
paramount	`p{r\@m{Ont
paranoia	p{r\@`noI@
paraphernalia	p{r\@f@`n{Ilj@
paraphrase	`p{r\@fr\{Iz
paraplegic	p{r\@`pli:dZIk
parasite	`p{r\@sAet
parcel	`p6:s@l
pardon	`p6:d@n
parent	`pe:r\@nt
Paris	p{r\@s
parish	`p{r\IS
park	p6:k
parka	`p6:k@
parliament	`p6:l@m@nt
parody	`p{r\@di:
parole	p@`r\@}l
parquet	`p6:k{I
parrot	`p{r\@t
parry	`p{r\i:
parsley	`p6:sli:
part	p6:t
part-time	p6:t`tAem
partial	`p6:S@l
participate	p@`tIs@p{It
participle	`p6:t@sIp@l
particle	`p6:tIk@l
particular	p@`tIkj@l@
partition	p6:`tIS@n
partner	`p6:tn@
party	`p6:ti:
pass	p6:s
passage	`p{sIdZ
passenger	`p{s@ndZ@
passers	p6:s@z
passion	`p{S@n
passionfruit	`p{S@nfr\}:t
passive	`p{sIv
passport	`p6:spo:t
password	`p6:sw3:d
past	p6:st
pasta	`p{st@
paste	p{Ist
pastel	`p{st@l
pasteurise	`p6:stS@r\Aez
pastime	`p6:stAem
pastry	`p{Istr\i:
pasture	`p6:stS@
pasty	`p{Isti:
pat	p{t
patch	p{tS
patent	`p{It@nt
paternal	p@`t3:n@l
paternity	p@`t3:n@ti:
path	p6:T
pathetic	p@`TetIk
pathology	p@`TOl@dZi:
patient	`p{IS@nt
patio	`p{ti:@}
patriarch	`p{Itr\i:6:k
patriot	`p{Itr\i:@t
patrol	p@`tr\@}l
patron	`p{Itr\@n
patronise	`p{tr\@nAez
patter	`p{t@
pattern	`p{t@n
Paul's	po:lz
pause	po:z
pave	p{Iv
pavement	`p{Ivm@nt
pavilion	p@`vIlj@n
pavlova	p{v`l@}v@
paw	po:
pawn	po:n
pay	p{I
PAYE	pi:{IwAe`i:
payroll	`p{Ir\@}l
pea	pi:
peace	pi:s
peach	pi:tS
peak	pi:k
peal	pi:l
pearl	p3:l
peasant	`pez@nt
peat	pi:t
pebble	`peb@l
peck	pek
peckish	`pekIS
peculiar	p@`kj}:lj@
ped	ped
pedal	`ped@l
pedantic	p@`d{ntIk
peddle	`ped@l
pedestal	`ped@st@l
pedestrian	p@`destr\i:@n
pee	pi:
peek	pi:k
peel	pi:l
peep	pi:p
peer	pI@
peeve	pi:v
peevish	`pi:vIS
peg	peg
pelt	pelt
pelvis	`pelv@s
pen	pen
penal	`pi:n@l
penalise	`pen@lAez
penalty	`pen@lti:
pencil	`pens@l
pend	pend
pendant	`pend@nt
penetrate	`pen@tr\{It
penfriend	`penfr\end
penguin	`peNgw@n
penicillin	pen@`sIl@n
peninsula	p@`nInS@l@
penis	`pi:n@s
penknife	`pennAef
penny	`peni:
pension	`penS@n
pent	pent
pentathlon	pen`t{TlOn
penthouse	`penth{Os
people	`pi:p@l
pepper	`pep@
peppermint	`pep@m@nt
per	p3:
perceive	p@`si:v
perception	p@`sepS@n
perch	p3:tS
percolate	`p3:k@l{It
perfect	`p3:fIkt
perform	p@`fo:m
perfume	`p3:fj}:m
pergola	p@`g@}l@
perhaps	p@`h{ps
peril	`per\@l
period	`pI@r\i:@d
periodical	pI@r\i:`OdIk@l
peripheral	p@`r\If@r\@l
perish	`per\IS
perishable	`per\IS@b@l
perjure	`p3:dZ@
perk	p3:k
permanent	`p3:m@n@nt
permission	p@`mIS@n
permit	p@`mIt
perpetrate	`p3:p@tr\{It
perpetual	p@`petS}:@l
persecute	`p3:s@kj}:t
persevere	p3:s@`vI@
Persian	`p3:Z@n
persist	p@`sIst
person	`p3:s@n
personal	`p3:s@n@l
personality	p3:s@`n{l@ti:
personify	p@`sOn@fAe
personnel	p3:s@`nel
perspire	p3:`spAe@
persuade	p@`sw{Id
pert	p3:t
pertinent	`p3:t@n@nt
perturb	p@`t3:b
perverse	p@`v3:s
pervert	`p3:v3:t
pessimism	`pes@mIz@m
pest	pest
pester	`pest@
pet	pet
petal	`pet@l
Pete	pi:t
petite	p@`ti:t
petition	p@`tIS@n
petrify	`petr\@fAe
petrol	`petr\@l
petroleum	p@`tr\@}li:@m
petticoat	`peti:k@}t
petty	`peti:
petulant	`petS@l@nt
pew	pj}:
pewter	`pj}:t@
phantom	`f{nt@m
pharmacist	`f6:m@s@st
phase	f{Iz
phenomenal	f@`nOm@n@l
phenomenon	f@`nOm@n@n
phew	fj}:
philosophy	f@`lOs@fi:
phlegm	flem
phlegmatic	fleg`m{tIk
phobia	`f@}bi:@
phone	f@}n
phonetics	f@`netIks
phoney	`f@}ni:
photo	`f@}t@}
photocopy	`f@}t@}`kOpi:
photogenic	f@}t@`dZi:nIk
photograph	`f@}t@gr\{f
phrase	fr\{Iz
physical	`fIzIk@l
physician	f@`zIS@n
physics	`fIzIks
physiology	fIzi:`Ol@dZi:
physiotherapist	fIzi:@}`Ter\@p@st
physique	f@`zi:k
piano	pi:`{n@}
pick	pIk
picked	pIkt
picket	`pIk@t
pickle	`pIk@l
pickpocket	`pIkpOk@t
picnic	`pIknIk
pictorial	pIk`to:r\i:@l
picture	`pIktS@
pidgin	`pIdZ@n
pie	pAe
piece	pi:s
pier	pI@
pierce	pI@s
pig	pIg
pig-headed	pIg`hed@d
pigment	`pIgm@nt
pigsty	`pIgstAe
pile	pAel
pile-up	`pAel6p
pilfer	`pIlf@
pilgrim	`pIlgr\@m
Pilipino	pIl@`pi:n@}
pill	pIl
pillar	`pIl@
pillion	pIlj@n
pillow	`pIl@}
pillowcase	`pIl@}k{Is
pills	pIlz
pilot	`pAel@t
pimple	`pImp@l
PIN	pIn
pin	pIn
pin-up	`pIn6p
pinch	pIntS
pine	pAen
ping-pong	`pINpON
pink	pINk
pioneer	pAe@`nI@
pious	`pAe@s
pip	pIp
pipe	pAep
pirate	`pAer\@t
pistol	`pIst@l
piston	`pIst@n
pit	pIt
pitch	pItS
pitch-dark	`pItSd6:k
pitfall	`pItfo:l
pith	pIT
pitiful	`pIt@f@l
pittance	`pIt@ns
pity	`pIti:
pivot	`pIv@t
placate	pl@`k{It
place	pl{Is
placid	`pl{s@d
plague	pl{Ig
plain	pl{In
plait	pl{t
plan	pl{n
plane	pl{In
planet	`pl{n@t
plank	pl{Nk
plant	pl{nt
plaque	pl6:k
plaster	`pl6:st@
plastered	`pl6:st@d
plastic	`pl{stIk
plate	pl{It
plateau	`pl{t@}
platform	`pl{tfo:m
platter	`pl{t@
platypus	`pl{t@pUs
plausible	`plo:z@b@l
play	pl{I
playground	`pl{Igr\{Ond
playwright	`pl{Ir\Aet
plea	pli:
plead	pli:d
pleasant	`plez@nt
please	pli:z
pleasure	`pleZ@
pleat	pli:t
pledge	pledZ
plenty	`plenti:
pliable	`plAe@b@l
pliers	`plAe@z
plight	plAet
plod	plOd
plonk	plONk
plot	plOt
plough	pl{O
ploy	ploI
pluck	pl6k
plucky	`pl6ki:
plug	pl6g
plughole	`pl6gh@}l
plumber	`pl6m@
plummet	`pl6m@t
plump	pl6mp
plunge	pl6ndZ
plural	`pl}:r\@l
plus	pl6s
plush	pl6S
ply	plAe
plywood	`plAewUd
pneumonia	nj}:`m@}nj@
PO	pi:`@}
poach	p@}tS
pocket	`pOk@t
pod	pOd
podgy	`pOdZi:
poem	`p@}@m
poetry	`p@}@tr\i:
point	poInt
point-blank	poInt`bl{Nk
pointless	`poIntl@s
poise	poIz
poison	`poIz@n
poke	p@}k
poker	`p@}k@
poky	`p@}ki:
pole	p@}l
police	p@`li:s
policy	`pOl@si:
polio	`p@}li:@}
Polish	`p@}lIS
polish	`pOlIS
Polish	p@}lIS
polish	pOlIS
polite	p@`lAet
politician	pOl@`tIS@n
politics	`pOl@tIks
poll	pOl
pollen	`pOl@n
pollute	p@`l}:t
polo	`p@}l@}
pommy	`pOmi:
pompous	`pOmp@s
pond	pOnd
ponder	`pOnd@
pong	pON
pony	`p@}ni:
ponytail	`p@}ni:t{Il
poo	p}:
poodle	p}:d@l
pooh	p}:
pool	p}:l
poor	po:
pop	pOp
Pope	p@}p
popular	`pOpj@l@
populate	`pOpj@l{It
porch	po:tS
porcupine	po:kj@pAen
pore	po:
pork	po:k
pornography	po:`nOgr\@fi:
porous	`po:r\@s
porridge	`pOr\IdZ
port	po:t
portable	`po:t@b@l
porter	`po:t@
portfolio	po:t`f@}li:@}
portion	`po:S@n
portrait	`po:tr\@t
portray	po:`tr\{I
Portuguese	po:tS@`gi:z
pose	p@}z
posh	pOS
position	p@`zIS@n
positive	`pOz@tIv
possess	p@`zes
possession	p@`zeS@n
possessive	p@`zesIv
possible	`pOs@b@l
possum	`pOs@m
post	p@}st
post-mortem	p@}st`mo:t@m
postbox	`p@}stbOks
postcard	`p@}stk6:d
postcode	`p@}stk@}d
poster	`p@}st@
posterior	pO`stI@r\i:@
posterity	pO`ster\@ti:
postgraduate	p@}st`gr\{dZ}:@t
postman	`p@}stm@n
postpone	p@}st`p@}n
postscript	`p@}stskr\Ipt
posture	`pOstS@
posy	`p@}zi:
pot	pOt
potato	p@`t{It@}
potent	`p@}t@nt
potential	p@`tenS@l
pothole	`pOth@}l
potter	`pOt@
potty	`pOti:
pouch	p{OtS
poultry	`p@}ltr\i:
pounce	p{Ons
pound	p{Ond
pour	po:
pout	p{Ot
poverty	`pOv@ti:
powder	`p{Od@
power	`p{O@
practical	`pr\{ktIk@l
practically	`pr\{ktIkli:
practice	`pr\{kt@s
practise	`pr\{kt@s
praise	pr\{Iz
pram	pr\{m
prance	pr\{ns
prank	pr\{Nk
prattle	`pr\{t@l
prawn	pr\o:n
pray	pr\{I
preach	pr\i:tS
precarious	pr\@`ke:r\i:@s
precaution	pr\@`ko:S@n
precede	pr\@`si:d
precedent	`pr\i:s@d@nt
precious	`pr\eS@s
precipice	`pr\es@p@s
precis	`pr\{Isi:
precise	pr\@`sAes
precocious	pr\@`k@}S@s
predecessor	`pr\i:d@ses@
predicament	pr\@`dIk@m@nt
predict	pr\@`dIkt
predictable	pr\@`dIkt@b@l
predominant	pr\@`dOm@n@nt
preen	pr\i:n
preface	`pr\ef@s
prefect	`pr\i:fekt
prefer	pr\@`f3:
prefix	`pr\i:fIks
pregnant	`pr\egn@nt
prejudice	`pr\edZ@d@s
preliminary	pr\@`lIm@nr\i:
prelude	`pr\elj}:d
premature	`pr\em@tSU@
premier	`pr\emi:@
premiere	pr\emi:`e:
premise	`pr\em@s
premium	`pr\i:mi:@m
premonition	`pr\em@nIS@n
preoccupied	pr\i:`Okj@pAed
prepare	pr\@`pe:
preposition	pr\ep@`zIS@n
preposterous	pr\@`pOstr\@s
prescribe	pr\@`skr\Aeb
prescription	pr\@`skr\IpS@n
present	`pr\ez@nt
presentable	pr\@`zent@b@l
presently	`pr\ez@ntli:
preserve	pr\@`z3:v
president	`pr\ez@d@nt
press	pr\es
press-up	`pr\es6p
pressure	`pr\eS@
prestige	pr\es`ti:Z
presume	pr\@`zj}:m
pretend	pr\@`tend
pretty	`pr\Iti:
prevalent	`pr\ev@l@nt
prevaricate	pr\@`v{r\@k{It
prevent	pr\@`vent
preview	`pr\i:vj}:
previous	`pr\i:vi:@s
prey	pr\{I
price	pr\Aes
priceless	`pr\Aesl@s
pricey	`pr\Aesi:
prick	pr\Ik
pride	pr\Aed
priest	pr\i:st
prig	pr\Ig
prim	pr\Im
primary	`pr\Aemr\i:
prime	pr\Aem
primitive	`pr\Im@tIv
prince	pr\Ins
princess	`pr\Inses
principal	`pr\Ins@p@l
principle	`pr\Ins@p@l
print	pr\Int
printer	`pr\Int@
prior	`pr\Ae@
priority	pr\Ae`Or\@ti:
prise	pr\Aez
prism	`pr\Iz@m
prison	`pr\Iz@n
private	`pr\Aev@t
privilege	`pr\Iv@lIdZ
prize	pr\Aez
probable	`pr\Ob@b@l
probe	pr\@}b
problem	`pr\Obl@m
procedure	pr\@`si:dZ@
proceed	pr\@`si:d
process	`pr\@}ses
prod	pr\Od
prodigy	`pr\Od@dZi:
produce	pr\@`dj}:s
product	`pr\Od6kt
productive	pr\@`d6ktIv
profession	pr\@`feS@n
professor	pr\@`fes@
proficient	pr\@`fIS@nt
profile	`pr\@}fAel
profit	`pr\Of@t
profound	pr\@`f{Ond
program	`pr\@}gr\{m
programme	`pr\@}gr\{m
progress	`pr\@}gr\es
progressive	pr\@`gr\esIv
prohibit	pr\@`hIb@t
project	`pr\@}dZekt
prologue	`pr\@}lOg
prolong	pr\@`lON
promenade	pr\Om@`n{Id
prominent	`pr\Om@n@nt
promise	`pr\Om@s
promote	pr\@`m@}t
prompt	pr\Ompt
prone	pr\@}n
prong	pr\ON
pronoun	`pr\@}n{On
pronounce	pr\@`n{Ons
pronounced	pr\@`n{Onst
proof	pr\}:f
proof-read	pr\}:fr\i:d
prop	pr\Op
propaganda	pr\Op@`g{nd@
propel	pr\@`pel
proper	`pr\Op@
property	`pr\Op@ti:
proportion	pr\@`po:S@n
proposals	pr\@p@}z@lz
propose	pr\@`p@}z
proprietor	pr\@`pr\Ae@t@
prose	pr\@}z
prosecute	`pr\Os@kj}:t
prospect	`pr\Ospekt
prospectus	pr\@`spekt@s
prosper	`pr\Osp@
prostitute	`pr\Ost@tj}:t
protect	pr\@`tekt
protective	pr\@`tektIv
protein	`pr\@}ti:n
protest	pr\@`test
Protestant	`pr\Ot@st@nt
protocol	`pr\@}t@kOl
prototype	`pr\@}t@}tAep
protracted	pr\@`tr\{kt@d
proud	pr\{Od
prove	pr\}:v
provide	pr\@`vAed
provision	pr\@`vIZ@n
provisional	pr\@`vIZ@n@l
provoke	pr\@`v@}k
prowl	pr\{Ol
proxy	`pr\Oksi:
prudent	`pr\}:d@nt
prune	pr\}:n
pry	pr\Ae
PS	pi:`es
pseudonym	`sj}:d@nIm
psych	sAek
psyche	`sAeki:
psychiatrist	s@`kAe@tr\@st
psychic	`sAekIk
psycho	`sAek@}
psychoanalyst	sAek@}`{n@l@st
psychology	sAe`kOl@dZi:
pub	p6b
puberty	`pj}:b@ti:
pubic	`pj}:bIk
public	`p6blIk
publican	`p6blIk@n
publication	p6bl@`k{IS@n
publicity	p6b`lIs@ti:
publish	`p6blIS
pucker	`p6k@
pudding	`pUdIN
puddle	`p6d@l
puff	p6f
puffin	p6f@n
pugnacious	p6g`n{IS@s
pull	pUl
pullover	`pUl@}v@
pulp	p6lp
pulse	p6ls
pump	p6mp
pumpkin	`p6mpk@n
pun	p6n
punch	p6ntS
punctual	`p6NktS}:@l
punctuation	p6NktS}:`{IS@n
puncture	`p6NktS@
punish	`p6nIS
punt	p6nt
puny	`pj}:ni:
pup	p6p
pupil	`pj}:p@l
puppet	`p6p@t
purchase	`p3:tS@s
pure	`pj}:@
puree	`pj}:r\{I
purge	p3:dZ
purple	`p3:p@l
purpose	`p3:p@s
purr	p3:
purse	p3:s
pursue	p@`sj}:
pus	p6s
push	pUS
push-up	`pUS6p
pushed	pUSt
pusher	`pUS@
pushover	`pUS@}v@
put	pUt
putty	`p6ti:
puzzle	`p6z@l
pyjamas	p@`dZ6:m@z
pylon	`pAelOn
pyramid	`pIr\@mId
python	`pAeT@n
Q	kj}:
q	kj}:
QC	kj}:`si:
Qld	`kwi:nzl@nd
quack	kw{k
quadrangle	`kwOdr\{Ng@l
quadriplegic	kwOdr\@`pli:dZIk
quadruped	`kwOdr\@ped
quadruple	kwOd`r\}:p@l
quadruplet	kwOd`r\}:pl@t
quaint	kw{Int
quake	kw{Ik
qualify	`kwOl@fAe
quality	`kwOl@ti:
quantity	`kwOnt@ti:
quarantine	`kwOr\@nti:n
quarrel	`kwOr\@l
quarry	`kwOr\i:
quarter	`kwo:t@
quartet	kwo:`tet
quay	ki:
queen	kwi:n
queer	`kwI@
query	`kwI@r\i:
quest	kwest
question	`kwestS@n
questionnaire	kwestS@n`e:
queue	kj}:
quibble	`kwIb@l
quiche	ki:S
quick	kwIk
quickly	kwIkli:
quicksand	`kwIks{nd
quiet	`kwAe@t
quilt	kwIlt
quinine	`kwIni:n
quip	kwIp
quit	kwIt
quite	kwAet
quiz	kwIz
quorum	`kwo:r\@m
quota	`kw@}t@
quotation	kw@}`t{IS@n
quote	kw@}t
R	6:
r	6:
rabbi	`r\{bAe
rabble	`r\{b@l
race	r\{Is
racecourse	`r\{Isko:s
racist	`r\{Is@st
rack	r\{k
racket	`r\{k@t
racquet	`r\{k@t
radar	`r\{Id6:
radiation	r\{Idi:`{IS@n
radiator	`r\{Idi:{It@
radical	`r\{dIk@l
radio	`r\{Idi:@}
radioactive	r\{Idi:@}`{ktIv
radiography	r\{Idi:`Ogr\@fi:
radiologist	r\{Idi:`Ol@dZ@st
radiotherapy	r\{Idi:@}`Ter\@pi:
radish	`r\{dIS
radius	`r\{Idi:@s
raffle	`r\{f@l
rafter	`r\6:ft@
rag	r\{g
rage	r\{IdZ
ragged	`r\{g@d
raid	r\{Id
rail	r\{Il
railing	`r\{IlIN
railway	`r\{Ilw{I
rain	r\{In
rainbow	`r\{Inb@}
rainforest	`r\{InfOr\@st
raise	r\{Iz
raisin	`r\{Iz@n
rake	r\{Ik
rally	`r\{li:
RAM	r\{m
ram	r\{m
ramble	`r\{mb@l
ramp	r\{mp
ramshackle	`r\{mS{k@l
ran	r\{n
random	`r\{nd@m
rang	r\{N
range	r\{IndZ
ranger	`r\{IndZ@
rank	r\{Nk
ransack	`r\{ns{k
ransom	`r\{ns@m
rape	r\{Ip
rapid	`r\{p@d
rare	r\e:
rash	r\{S
rasher	`r\{S@
rat	r\{t
rate	r\{It
rather	`r\6:D@
ratio	`r\{ISi:@}
ration	`r\{S@n
ratshit	`r\{tSIt
rattle	`r\{t@l
rave	r\{Iv
ravenous	`r\{v@n@s
ravine	r\@`vi:n
ravishing	`r\{v@SIN
raw	r\o:
ray	r\{I
razor	`r\{Iz@
re	r\i:
re-count	`r\i:k{Ont
reach	r\i:tS
react	r\i:`{kt
read	r\i:d
ready	`r\edi:
real	r\i:l
realise	`r\i:@lAez
realist	`r\i:@l@st
reality	r\i:`{l@ti:
really	`r\I@li:
realty	`r\i:@lti:
rear	`r\I@
reason	`r\i:z@n
reasonable	`r\i:z@n@b@l
rebate	`r\i:b{It
rebel	`r\eb@l
recall	`r\@ko:l
recede	r\@`si:d
receipt	r\@`si:t
receive	r\@`si:v
receiver	r\@`si:v@
recent	`r\i:s@nt
receptacle	r\@`sept@k@l
reception	r\@`sepS@n
receptionist	r\@`sepS@n@st
recess	r\@`ses
recession	r\@`seS@n
recipe	`r\es@pi:
recipient	r\@`sIpi:@nt
recital	r\@`sAet@l
recite	r\@`sAet
reckless	`r\ekl@s
reckon	`r\ek@n
recognise	`r\ek@gnAez
recoil	r\@`koIl
recollect	r\ek@`lekt
recommend	r\ek@`mend
reconcile	`r\ek@nsAel
record	r\@`ko:d
record-player	`r\eko:dpl{I@
recorder	r\@`ko:d@
recount	r\@`k{Ont
recover	r\@`k6v@
recreation	r\ekr\i:`{IS@n
recruit	r\@`kr\}:t
rectangle	`r\ekt{Ng@l
rectum	`r\ekt@m
recuperate	r\@`k}:p@r\{It
recur	r\@`k3:
recycle	r\i:`sAek@l
red	r\ed
red-back	`r\edb{k
redeem	r\@`di:m
reduce	r\@`dj}:s
redundant	r\@`d6nd@nt
reef	r\i:f
reel	r\i:l
refer	r\@`f3:
referee	r\ef@`r\i:
reference	`r\efr\@ns
referendum	r\ef@`r\end@m
reflect	r\@`flekt
reflex	`r\i:fleks
reform	r\@`fo:m
refrain	r\@`fr\{In
refresh	r\@`fr\eS
refreshments	r\@`fr\eSm@nts
refrigerator	r\@`fr\IdZ@r\{It@
refuge	`r\efj}:dZ
refugee	r\efj}:`dZi:
refund	`r\i:f6nd
refuse	r\@`fj}:z
regain	r\@`g{In
regard	r\@`g6:d
regardless	r\@`g6:dl@s
regime	r\{I`Zi:m
region	`r\i:dZ@n
register	`r\edZ@st@
registry	`r\edZ@str\i:
rego	`r\edZ@}
regret	r\@`gr\et
regular	`r\egj@l@
regulate	`r\egj@l{It
regulation	r\egj@`l{IS@n
rehabilitate	r\i:h@`bIl@t{It
rehearse	r\@`h3:s
reign	r\{In
reimburse	r\i:Im`b3:s
rein	r\{In
reincarnation	r\i:Ink6:`n{IS@n
reinforce	r\i:In`fo:s
reinforcements	r\i:In`fo:sm@nts
reinstate	r\i:In`st{It
reject	r\@`dZekt
rejoice	r\@`dZoIs
relapse	r\@`l{ps
relate	r\@`l{It
relation	r\@`l{IS@n
relationship	r\@`l{IS@nSIp
relative	`r\el@tIv
relatively	`r\el@tIvli:
relax	r\@`l{ks
relaxing	r\@l{ksIN
relay	`r\i:l{I
release	r\@`li:s
relent	r\@`lent
relentless	r\@`lentl@s
relevant	`r\el@v@nt
reliable	r\@`lAe@b@l
reliant	r\@`lAe@nt
relic	`r\elIk
relief	r\@`li:f
relieve	r\@`li:v
religion	r\@`lIdZ@n
relish	r\elIS
reluctant	r\@`l6kt@nt
rely	r\@`lAe
remain	r\@`m{In
remainder	r\@`m{Ind@
remark	r\@`m6:k
remarkable	r\@`m6:k@b@l
remarry	r\i:`m{r\i:
remedy	`r\em@di:
remember	r\@`memb@
remind	r\@`mAend
remittance	r\@`mIt@ns
remnant	`r\emn@nt
remote	r\@`m@}t
removalist	r\@`m}:v@l@st
remove	r\@`m}:v
renal	`r\i:n@l
renew	r\@`nj}:
renounce	r\@`n{Ons
renovate	`r\en@v{It
rent	r\ent
rental	`r\ent@l
repair	r\@`pe:
repay	r\i:`p{I
repayment	r\@`p{Im@nt
repeat	r\@`pi:t
repeated	r\@`pi:t@d
repel	r\@`pel
repellent	r\@`pel@nt
repent	r\@`pent
replace	r\@`pl{Is
replay	`r\i:pl{I
replica	`r\eplIk@
reply	r\@`plAe
report	r\@`po:t
reporter	r\@`po:t@
repossess	r\i:p@`zes
represent	r\epr\@`zent
representative	r\epr\@`zent@tIv
reprieve	r\@`pr\i:v
reprimand	`r\epr\@m{nd
reprint	r\i:`pr\Int
reproach	r\@`pr\@}tS
reproduce	r\i:pr\@`dj}:s
reptile	`r\eptAel
republic	r\@`p6blIk
repugnant	r\@`p6gn@nt
repulsive	r\@`p6lsIv
reputable	`r\epj@t@b@l
reputation	r\epj@`t{IS@n
reputed	r\@`pj}:t@d
request	r\@`kwest
require	r\@`kwAe@
rescue	`r\eskj}:
research	r\@`s3:tS
resemble	r\@`zemb@l
resent	r\@`zent
reservation	r\ez@`v{IS@n
reserve	r\@`z3:v
reserved	r\@`z3:vd
reservoir	`r\ez@vw6:
residence	`r\ez@d@ns
resident	`r\ez@d@nt
residential	r\ez@`denS@l
residue	`r\ez@dj}:
resign	r\@`zAen
resist	r\@`zIst
resistance	r\@zIst@ns
resistant	r\@`zIst@nt
resolute	`r\ez@l}:t
resolution	r\ez@`l}:S@n
resolve	r\@`zOlv
resort	r\@`zo:t
resource	r\@`zo:s
resourceful	r\@`zo:sfUl
respect	r\@`spekt
respectable	r\@`spekt@b@l
respectively	r\@`spektIvli:
respiration	r\esp@`r\{IS@n
respond	r\@`spOnd
responsible	r\@`spOns@b@l
rest	r\est
restaurant	`r\est@r\Ont
restless	`r\estl@s
restore	r\@`sto:
restrain	r\@`str\{In
restrained	r\@`str\{Ind
restrict	r\@`str\Ikt
result	r\@`z6lt
resume	`r\eZ@m{I
resurrect	r\ez@`r\ekt
resuscitate	r\@`s6s@t{It
retail	`r\i:t{Il
retain	r\@`t{In
retaliate	r\@`t{li:{It
retire	r\@`tAe@
retrace	r\i:`tr\{Is
retreat	r\@`tr\i:t
retrench	r\@`tr\entS
retrieve	r\@`tr\i:v
retrospective	r\etr\@`spektIv
return	r\@`t3:n
reunion	r\i:`j}:nj@n
reveal	r\@`vi:l
revel	`r\ev@l
revenge	r\@`vendZ
revenue	`r\ev@nj}:
Reverend	`r\evr\@nd
reverent	`r\evr\@nt
reverse	r\@`v3:s
revert	r\@`v3:t
review	r\@`vj}:
revise	r\@`vAez
revive	r\@`vAev
revolt	r\@`v@}lt
revolution	r\ev@`l}:S@n
revolutionary	r\ev@`l}:S@nr\i:
revolve	r\@`vOlv
revolver	r\@`vOlv@
reward	r\@`wo:d
rewarding	r\@`wo:dIN
rheumatism	`r\}:m@tIz@m
rhyme	r\Aem
rhythm	`r\ID@m
rib	r\Ib
ribbon	`r\Ib@n
rice	r\Aes
rich	r\ItS
rid	r\Id
riddle	`r\Id@l
ride	r\Aed
ridge	r\IdZ
ridicule	`r\Id@kj}:l
ridiculous	r\@`dIkj@l@s
rifle	`r\Aef@l
rift	r\Ift
rig	r\Ig
right	r\Aet
rightful	`r\Aetf@l
rigid	`r\IdZ@d
rim	r\Im
rind	r\Aend
ring	r\IN
ring-in	`r\INIn
ringworm	`r\INw3:m
rinse	r\Ins
riot	`r\Ae@t
rip	r\Ip
ripcord	`r\Ipko:d
ripe	r\Aep
ripple	`r\Ip@l
rise	r\Aez
risk	r\Isk
risks	r\Isks
risky	r\Iski:
rival	`r\Aev@l
river	`r\Iv@
road	r\@}d
roadway	`r\@}dw{I
roadworks	`r\@}dw3:ks
roam	r\@}m
roar	r\o:
roaring	r\o:r\IN
roast	r\@}st
rob	r\Ob
robbery	`r\Ob@r\i:
robe	r\@}b
robot	`r\@}bOt
robust	`r\@}b6st
rock	r\Ok
rockery	`r\Ok@r\i:
rocket	`r\Ok@t
rod	r\Od
rode	r\@}d
rogue	r\@}g
role	r\@}l
roll	r\@}l
roller-skate	`r\@}l@sk{It
rolling	r\@}lIN
ROM	r\Om
Roman	`r\@}m@n
romance	r\@`m{ns
Romanian	r\@}`m{Ini:@n
romp	r\Omp
roof	r\}:f
room	r\}:m
rooms	r\}:mz
rooster	`r\}:st@
root	r\}:t
rope	r\@}p
ropeable	`r\@}p@b@l
rort	r\o:t
Rosas	r\@}z@z
rose	r\@}z
roses	r\@}z@z
roster	`r\Ost@
rosy	`r\@}zi:
rot	r\Ot
rotate	r\@}`t{It
rotten	`r\Ot@n
rough	r\6f
roughage	`r\6fIdZ
roulette	r\}:`let
round	r\{Ond
roundabout	`r\{Ond@b{Ot
rouse	r\{Oz
route	r\}:t
routine	r\}:`ti:n
row	r\@}
rowdy	`r\{Odi:
royal	`r\oI@l
royalty	`r\oI@lti:
RSL	6:r\es`el
RSVP	6:r\esvi:`pi:
rub	r\6b
rubber	`r\6b@
rubbish	`r\6bIS
rubble	`r\6b@l
rubella	r\}:`bel@
ruby	`r\}:bi:
rucksack	`r\6ks{k
rudder	`r\6d@
ruddy	`r\6di:
rude	r\}:d
ruffian	`r\6fi:@n
rug	r\6g
rugby	`r\6gbi:
rugged	`r\6g@d
ruin	`r\}:@n
rule	r\}:l
ruler	`r\}:l@
rum	r\6m
rumble	`r\6mb@l
rummage	`r\6mIdZ
rumour	`r\}:m@
rump	r\6mp
rumple	`r\6mp@l
rumpus	`r\6mp@s
run	r\6n
run-down	r\6n`d{On
rung	r\6N
runner-up	r\6n@r\`6p
runny	`r\6ni:
runt	r\6nt
runway	`r\6nw{I
rupture	`r\6ptS@
rural	`r\}:r\@l
rush	r\6S
rust	r\6st
rut	r\6t
ruthless	`r\}:Tl@s
S	es
s	es
SA	s{OT@`str\{Ilj@
Sabbath	`s{b@T
sabotage	`s{b@t6:Z
saccharin	`s{k@r\@n
sachet	`s{S{I
sack	s{k
sacrament	`s{kr\@m@nt
sacred	`s{Ikr\@d
sacrifice	`s{kr\@fAes
sacrilege	`s{kr\@lIdZ
sad	s{d
saddle	`s{d@l
safari	s@`f6:r\i:
safe	s{If
sag	s{g
saga	`s6:g@
sage	s{IdZ
said	sed
sail	s{Il
sailor	`s{Il@
saint	s{Int
sake	s{Ik
salad	`s{l@d
salami	s@`l6:mi:
salary	`s{l@r\i:
sale	s{Il
salesperson	`s{Ilzp3:s@n
saline	`s{IlAen
saliva	s@`lAev@
sallow	`s{l@}
salon	`s{lOn
saloon	s@`l}:n
salt	sOlt
salute	s@`l}:t
salvage	`s{lvIdZ
salvation	s{l`v{IS@n
same	s{Im
sample	`s{mp@l
sanatorium	s{n@`to:r\i:@m
sanction	`s{NkS@n
sand	s{nd
sandal	`s{nd@l
sandpaper	`s{ndp{Ip@
sandwich	`s{nwItS
sandy	s{ndi:
sane	s{In
sang	s{N
sanitary	s{n@tr\i:
sank	s{Nk
sap	s{p
sapphire	`s{fAe@
sarcasm	`s6:k{z@m
sardine	s6:`di:n
sari	`s6:r\i:
sarong	s@`r\ON
sash	s{S
sat	s{t
satchel	`s{tS@l
satellite	`s{t@lAet
satin	`s{t@n
satire	`s{tAe@
satisfactory	s{t@s`f{ktr\i:
satisfy	`s{t@sfAe
saturate	`s{tS@r\{It
Saturday	`s{t@d{I
sauce	so:s
saucepan	`so:sp@n
saucer	`so:s@
sauna	`so:n@
saunter	`so:nt@
sausage	`sOsIdZ
saute	`so:t{I
savage	`s{vIdZ
save	s{Iv
saviour	`s{Ivj@
savour	`s{Iv@
savoury	`s{Iv@r\i:
saw	so:
sawing	so:r\IN
say	s{I
says	sez
scab	sk{b
scaffold	`sk{f@}ld
scaffolding	`sk{f@ldIN
scald	sko:ld
scale	sk{Il
scallop	`skOl@p
scalp	sk{lp
scalpel	`sk{lp@l
scam	sk{m
scamp	sk{mp
scamper	`sk{mp@
scan	sk{n
scandal	`sk{nd@l
Scandinavian	sk{nd@`n{Ivi:@n
scant	sk{nt
scapegoat	`sk{Ipg@}t
scar	sk6:
scarce	ske:s
scarcely	`ske:sli:
scare	ske:
scarecrow	`ske:kr\@}
scared	ske:d
scarf	sk6:f
scarlet	`sk6:l@t
scary	`ske:r\i:
scathing	`sk{IDIN
scatter	`sk{t@
scatterbrain	`sk{t@br\{In
scatty	`sk{ti:
scavenge	`sk{v@ndZ
scene	si:n
scenery	`si:n@r\i:
scenes	si:nz
scent	sent
sceptical	`skeptIk@l
schedule	`SedZ}:l
scheme	ski:m
scholar	`skOl@
scholarship	`skOl@SIp
school	sk}:l
schooner	`sk}:n@
science	`sAe@ns
scientist	`sAe@nt@st
scissors	`sIz@z
scoff	skOf
scold	sk@}ld
scone	skOn
scoop	sk}:p
scooter	`sk}:t@
scope	sk@}p
scorch	sko:tS
score	sko:
scorn	sko:n
scorpio	sko:pi:@}
scot-free	skOt`fr\i:
scotch	skOtS
Scottish	`skOtIS
scoundrel	`sk{Ondr\@l
scout	sk{Ot
scowl	sk{Ol
scrabble	`skr\{b@l
scraggy	`skr\{gi:
scramble	`skr\{mb@l
scrap	skr\{p
scrape	skr\{Ip
scratch	skr\{tS
scrawl	skr\o:l
scream	skr\i:m
screech	skr\i:tS
screen	skr\i:n
screw	skr\}:
screwdriver	`skr\}:dr\Aev@
scribble	`skr\Ib@l
scrimp	skr\Imp
script	skr\Ipt
scripture	`skr\IptS@
scroll	skr\@}l
scrotum	`skr\@}t@m
scrounge	skr\{OndZ
scrub	skr\6b
scruff	skr\6f
scruffy	`skr\6fi:
scrum	skr\6m
scrupulous	`skr\}:pj@l@s
scrutinise	`skr\}:t@nAez
scuff	sk6f
scuffle	`sk6f@l
scullery	`sk6l@r\i:
sculpture	`sk6lptS@
scum	sk6m
scurry	`sk6r\i:
scuttle	`sk6t@l
sea	si:
seafood	`si:f}:d
seagull	si:g6l
seal	si:l
seam	si:m
seance	`s{IOns
search	s3:tS
seashore	`si:So:
seasickness	`si:sIkn@s
seaside	`si:sAed
season	`si:z@n
seasonal	`si:z@n@l
seat	si:t
sec	sek
secateurs	`sek@t@z
second	`sek@nd
second-class	`sek@ndkl6:s
second-hand	sek@nd`h{nd
second-rate	`sek@ndr\{It
secondary	`sek@ndr\i:
seconds	sek@ndz
secret	`si:kr\@t
secretary	`sekr\@tr\i:
secrete	s@`kr\i:t
sect	sekt
section	`sekS@n
sector	`sekt@
secular	`sekj@l@
secure	s@`kj}:@
security	s@`kj}:r\@ti:
sedan	s@`d{n
sedate	s@`d{It
sedative	`sed@tIv
sediment	`sed@m@nt
seduce	s@`dj}:s
see	si:
seed	si:d
seedling	`si:dlIN
seedy	`si:di:
seek	si:k
seem	si:m
seems	si:mz
seen	si:n
seep	si:p
seesaw	`si:so:
segment	`segm@nt
segregate	`segr\@g{It
seize	si:z
seldom	`seld@m
select	s@`lekt
selective	s@`lektIv
self	self
self-absorbed	self@bzo:bd
self-centred	self`sent@d
self-confident	self`kOnf@d@ns
self-conscious	self`kOnS@s
self-defence	selfd@`fens
self-service	self`s3:v@s
selfish	`selfIS
sell	sel
semen	`si:m@n
semester	s@`mest@
semi-conscious	semi:`kOnS@s
semi-detached	semi:d@`t{tSt
semicolon	semi:`k@}l@n
seminar	`sem@n6:
seminary	`sem@nr\i:
semitrailer	semi:`tr\{Il@
Senate	`sen@t
senator	`sen@t@
send	send
senile	`senAel
senior	`si:nj@
sensation	sen`s{IS@n
sensational	sen`s{IS@n@l
sense	sens
sensible	`sens@b@l
sensitive	`sens@tIv
sent	sent
sentence	`sent@ns
sentiment	`sent@m@nt
sentimental	sent@`ment@l
sentry	`sentr\i:
separate	`sepr\@t
Sept.	s@p`temb@
September	s@p`temb@
septic	`septIk
sequel	`si:kw@l
sequence	`si:kw@ns
Serbian	`s3:bi:@n
serenade	ser\@n{Id
serene	s@`r\i:n
sergeant	`s6:dZ@nt
serial	`sI@r\i:@l
series	`sI@r\i:z
serious	`sI@r\i:@s
sermon	`s3:m@n
serpent	`s3:p@nt
serrated	s@`r\{It@d
serum	`sI@r\@m
servant	`s3:v@nt
serve	s3:v
service	`s3:v@s
serviceable	`s3:v@s@b@l
serviette	s3:vi:`et
serving	`s3:vIN
session	`seS@n
set	set
set-up	`set6p
setback	`setb{k
settee	se`ti:
setting	`setIN
settle	`set@l
seven	`sev@n
seventeen	sev@n`ti:n
seventeenth	sev@n`ti:nT
seventh	`sev@nT
seventies	`sev@nti:z
seventy	`sev@nti:
sever	`sev@
several	`sevr\@l
severe	s@`vI@
sew	s@}
sewage	`s}:IdZ
sewer	`s}:@
sewerage	`s}:@r\IdZ
sex	seks
sexism	`seksIz@m
sexy	`seksi:
shabby	`S{bi:
shack	S{k
shade	S{Id
shadow	`S{d@}
shaggy	`S{gi:
shake	S{Ik
shake-up	`S{Ik6p
shall	S{l
shallow	`S{l@}
sham	S{m
shame	S{Im
shampoo	S{m`p}:
shandy	`S{ndi:
shant	S6:nt
shanty	`S{nti:
shape	S{Ip
share	Se:
shareholder	`Se:h@}ld@
shark	S6:k
Sharon	S{r\@n
sharp	S6:p
sharpener	`S6:pn@
shatter	`S{t@
shave	S{Iv
shaw	So:
Shaw	So:
shawl	So:l
she	Si:
she'll	Si:l
shear	SI@
shed	Sed
sheep	Si:p
sheepish	`Si:pIS
sheer	SI@
sheet	Si:t
shelf	Self
shell	Sel
shellfish	`SelfIS
shelter	`Selt@
shelve	Selv
shelving	`SelvIN
sheriff	Ser\@f
shield	Si:ld
shift	SIft
shifty	`SIfti:
shimmer	`SIm@
shin	SIn
shine	SAen
shingle	`SINg@l
ship	SIp
shipment	`SIpm@nt
shipshape	`SIpS{Ip
shirk	S3:k
shirt	S3:t
shit	SIt
shiver	`SIv@
shock	SOk
shoddy	`SOdi:
shoe	S}:
shone	SOn
shook	SUk
shoot	S}:t
shop	SOp
shopkeeper	`SOpki:p@
shoplift	`SOplIft
shore	So:
shorn	So:n
short	So:t
short-sighted	So:t`sAet@d
short-tempered	So:t`temp@d
shortage	`So:tIdZ
shortcoming	`So:tk6mIN
shortcut	So:tk6t
shorten	`So:t@n
shorthand	`So:th{nd
shortly	`So:tli:
shot	SOt
shotgun	`SOtg6n
should	SUd
shoulder	`S@}ld@
shout	S{Ot
shove	S6v
shovel	`S6v@l
show	S@}
show-off	`S@}Of
showdown	`S@}d{On
shower	`S{O@
showy	`S@}i:
shred	Sr\ed
shrew	Sr\}:
shrewd	Sr\}:d
shriek	Sr\i:k
shrill	Sr\Il
shrimp	Sr\Imp
shrink	Sr\INk
shrivel	`Sr\Iv@l
shrub	Sr\6b
shrug	Sr\6g
shudder	`S6d@
shuffle	`S6f@l
shun	S6n
shut	S6t
shutter	`S6t@
shy	SAe
sibling	`sIblIN
sick	sIk
sicken	`sIk@n
sickening	`sIk@nIN
sickie	`sIki:
sickly	`sIkli:
sickness	`sIkn@s
side	sAed
side-effects	`sAed@fekts
sideshow	`sAedS@}
sideways	`sAedw{Iz
siege	si:dZ
siesta	si:`est@
sieve	sIv
sift	si:ft
sigh	sAe
sight	sAet
sightseeing	`sAetsi:IN
sign	sAen
signal	`sIgn@l
signature	`sIgn@tS@
significant	sIg`nIf@k@nt
silence	`sAel@ns
silhouette	sIl@wet
silk	sIlk
silkworm	`sIlkw3:m
sill	sIl
silly	`sIli:
silver	`sIlv@
similar	`sIm@l@
simmer	`sIm@
simple	`sImp@l
simple-minded	`sImp@lmAend@d
simply	`sImpli:
simultaneous	sIm@l`t{Ini:@s
sin	sIn
since	sIns
sincere	sIn`sI@
sincerely	sIn`sI@li:
sing	sIN
singe	sIndZ
single	`sINg@l
single-handed	sINg@l`h{nd@d
single-minded	sINg@l`mAend@d
singlet	`sINl@t
singsong	`sINsON
singular	`sINgj@l@
sinister	`sIn@st@
sink	sINk
sinker	`sINk@
sinus	`sAen@s
sinusitis	sAen@`sAet@s
sip	sIp
sir	s3:
siren	`sAer\@n
sissy	`sIsi:
sister	`sIst@
sister-in-law	`sIst@r\Inlo:
sit	sIt
sit-in	`sItIn
sitcom	`sItkOm
site	sAet
sitter	`sIt@
situated	`sItS}:{It@d
situation	sItS}:`{IS@n
six	sIks
sixteen	sIks`ti:n
sixteenth	sIks`ti:nT
sixth	sIksT
sixty	`sIksti:
size	sAez
sizeable	`sAez@b@l
sizzle	`sIz@l
skate	sk{It
skein	sk{In
skeleton	`skel@t@n
sketch	sketS
sketchy	`sketSi:
skewer	`skj}:@
ski	ski:
skid	skId
skilful	`skIlf@l
skill	skIl
skim	skIm
skimp	skImp
skimpy	`skImpi:
skin	skIn
skinny	`skIni:
skip	skIp
skirt	sk3:t
skivvy	`skIvi:
skull	sk6l
sky	skAe
skyscraper	`skAeskr\{Ip@
slab	sl{b
slack	sl{k
slacken	`sl{k@n
slam	sl{m
slammer	`sl{m@
slander	`sl{nd@
slang	sl{N
slant	sl{nt
slap	sl{p
slapdash	`sl{pd{S
slapstick	`sl{pstIk
slash	sl{S
slat	sl{t
slate	sl{It
slaughter	`slo:t@
slave	sl{Iv
slay	sl{I
sleazy	`sli:zi:
sledge	sledZ
sledgehammer	`sledZh{m@
sleek	sli:k
sleep	sli:p
sleeve	sli:v
slender	`slend@
slice	slAes
slick	slIk
slide	slAed
slight	slAet
slim	slIm
slime	slAem
sling	slIN
slink	slINk
slinky	`slINki:
slip	slIp
slippers	`slIp@z
slippery	`slIp@r\i:
slit	slIt
slob	slOb
slobber	`slOb@
slog	slOg
slogan	`sl@}g@n
slop	slOp
slope	sl@}p
sloppily	slOp@li:
sloppy	`slOpi:
slosh	slOS
sloshed	slOSt
slot	slOt
sloth	sloT
slouch	sl{OtS
slovenly	`sl6v@nli:
slow	sl@}
slowly	sl@}li:
sludge	sl6dZ
slug	sl6g
sluggish	`sl6gIS
slum	sl6m
slump	sl6mp
slung	sl6N
slur	sl3:
slurp	sl3:p
slush	sl6S
slut	sl6t
sly	slAe
smack	sm{k
small	smo:l
smaller	smo:l@
smallgoods	`smo:lgUdz
smallpox	`smo:lpOks
smart	sm6:t
smash	sm{S
smear	smI@
smell	smel
smelt	smelt
smelter	`smelt@
smile	smAel
smirk	sm3:k
smithereens	smID@`r\i:nz
smog	smOg
smoke	sm@}k
smokescreen	`sm@}kskr\i:n
smooth	sm}:D
smorgasbord	`smo:g@sbo:d
smother	`sm6D@
smoulder	`sm@}ld@
smudge	sm6dZ
smug	sm6g
smuggle	`sm6g@l
snack	sn{k
snag	sn{g
snail	sn{Il
snake	sn{Ik
snap	sn{p
snappy	`sn{pi:
snapshot	`sn{pSOt
snarl	sn6:l
snatch	sn{tS
sneak	sni:k
sneer	snI@
sneeze	sni:z
sniff	snIf
sniffle	`snIf@l
snigger	`snIg@
snip	snIp
snipe	snAep
snivel	`snIv@l
snob	snOb
snooker	`sn}:k@
snoop	sn}:p
snooty	`sn}:ti:
snooze	sn}:z
snore	sno:
snorkel	`sno:k@l
snort	sno:t
snout	sn{Ot
snow	sn@}
snub	sn6b
snug	sn6g
snuggle	`sn6g@l
so	s@}
so-and-so	`s@}@ns@}
soak	s@}k
soap	s@}p
soar	so:
sob	sOb
sober	`s@}b@
soccer	`sOk@
social	`s@}S@l
socialise	`s@}S@lAez
socialism	`s@}S@lIz@m
society	s@`sAe@ti:
sociology	s@}si:`Ol@dZi:
sock	sOk
socket	`sOk@t
soda	`s@}d@
sodium	`s@}di:@m
sofa	`s@}f@
soft	sOft
soggy	`sOgi:
soil	soIl
solar	`s@}l@
sold	s@}ld
soldier	`s@}ldZ@
sole	s@}l
solemn	`sOl@m
solicitor	s@`lIs@t@
solid	`sOl@d
solitary	`sOl@tr\i:
solo	`s@}l@}
soloist	`s@}l@}@st
soluble	`sOlj@b@l
solution	s@`l}:S@n
solve	sOlv
sombre	`sOmb@
some	s6m
somebody	`s6mbOdi:
somehow	`s6mh{O
someone	`s6mw6n
somersault	`s6m@sOlt
something	`s6mTIN
sometime	`s6mtAem
sometimes	`s6mtAemz
somewhere	`s6mwe:
son	s6n
son-in-law	`s6nInlo:
song	sON
soon	s}:n
soot	sUt
soothe	s}:D
sophisticated	s@`fIst@k{It@d
sopping	`sOpIN
soprano	s@`pr\6:n@}
sorbet	`so:b{I
sordid	`so:d@d
sore	so:
sorrow	`sOr\@}
sorry	`sOr\i:
sort	so:t
souffle	`s}:fl{I
sought	so:t
soul	s@}l
sound	s{Ond
soup	s}:p
sour	`s{O@
source	so:s
south	s{OT
souvenir	s}:v@`nI@
soviet	`s@}vi:@t
sow	s@}
spa	sp6:
space	sp{Is
spacecraft	`sp{Iskr\6:ft
spacious	`sp{IS@s
spade	sp{Id
spaghetti	sp@`geti:
span	sp{n
Spanish	`sp{nIS
spank	sp{Nk
spanner	`sp{n@
spare	spe:
spark	sp6:k
sparkle	`sp6:k@l
sparse	sp6:s
spasm	`sp{z@m
spasmodic	sp{z`mOdIk
spastic	`sp{stIk
speak	spi:k
speaker	`spi:k@
spear	spI@
special	`speS@l
specialise	`speS@lAez
specialised	`speS@lAezd
specialist	`speS@l@st
specially	`speS@li:
species	`spi:si:z
specific	sp@`sIfIk
specification	spes@f@`k{IS@n
specify	`spes@fAe
specimen	`spes@m@n
speck	spek
spectacle	`spekt@k@l
spectacles	`spekt@k@lz
spectacular	spek`t{kj@l@
spectator	spek`t{It@
spectrum	`spektr\@m
speculate	`spekj@l{It
sped	sped
speech	spi:tS
speed	spi:d
speedometer	spi:`dOm@t@
spell	spel
spelt	spelt
spencer	`spens@
spend	spend
spendthrift	`spendTr\Ift
spent	spent
sperm	sp3:m
spew	spj}:
sphere	sfI@
spice	spAes
spider	`spAed@
spike	spAek
spiky	spAeki:
spill	spIl
spilt	spIlt
spin	spIn
spin-dry	spIn`dr\Ae
spine	spAen
spineless	`spAenl@s
spinnaker	`spIn@k@
spinster	`spInst@
spiny	`spAeni:
spiral	`spAer\@l
spire	`spAe@
spirit	`spIr\@t
spiritual	`spIr\@tS@l
spit	spIt
spite	spAet
spiteful	`spAetfUl
splash	spl{S
splatter	`spl{t@
spleen	spli:n
splendid	`splend@d
splint	splInt
splinter	`splInt@
split	splIt
split-level	`splItlev@l
splotch	splOtS
splutter	`spl6t@
spoil	spoIl
spoke	sp@}k
spoken	`sp@}k@n
spokesperson	`sp@}ksp3:s@n
sponge	sp6ndZ
sponsor	`spOns@
sponsorship	`spOns@SIp
spontaneous	spOn`t{Ini:@s
spook	sp}:k
spooky	`sp}:ki:
spoon	sp}:n
sporadic	sp@`r\{dIk
sport	spo:t
sports	spo:ts
spot	spOt
spotless	`spOtl@s
spotted	`spOt@d
spotty	`spOti:
spouse	sp{Os
spout	sp{Ot
sprain	spr\{In
sprang	spr\{N
sprawl	spr\o:l
spray	spr\{I
spread	spr\ed
spree	spr\i:
spring	spr\IN
spring-clean	spr\IN`kli:n
Springwood	spr\INwUd
sprinkle	`spr\INk@l
sprinkler	`spr\INkl@
sprint	spr\Int
sprout	spr\{Ot
sprouts	spr\{Ots
sprung	spr\6N
spud	sp6d
spun	sp6n
spur	sp3:
spurt	sp3:t
spy	spAe
squabble	`skwOb@l
squad	skwOd
squalid	`skwOl@d
squander	`skwOnd@
square	skwe:
squash	skwOS
squeak	skwi:k
squeal	skwi:l
squeeze	skwi:z
squint	skwInt
squirm	skw3:m
squirt	skw3:t
stab	st{b
stable	`st{Ib@l
stack	st{k
stadium	`st{Idi:@m
staff	st6:f
stage	st{IdZ
stagger	`st{g@
stagnant	`st{gn@nt
stain	st{In
stair	ste:
staircase	`ste:k{Is
stake	st{Ik
stale	st{Il
stalk	sto:k
stall	sto:l
stamina	`st{m@n@
stammer	`st{m@
stamp	st{mp
stampede	st{m`pi:d
stand	st{nd
stand-by	`st{ndbAe
standard	`st{nd@d
standing	`st{ndIN
standstill	`st{ndstIl
staple	`st{Ip@l
stapler	`st{Ipl@
star	st6:
starch	st6:tS
stare	ste:
stark	st6:k
start	st6:t
startle	`st6:t@l
starve	st6:v
state	st{It
statement	`st{Itm@nt
static	`st{tIk
station	`st{IS@n
stationary	`st{IS@nr\i:
stationery	`st{IS@nr\i:
statistics	st@`tIstIks
statue	`st{tS}:
status	`st{It@s
statute	`st{tS}:t
stay	st{I
STD	esti:`di:
steadfast	`stedf6:st
steady	`stedi:
steak	st{Ik
steal	sti:l
steam	sti:m
steel	sti:l
steep	sti:p
steeple	sti:p@l
steer	stI@
stem	stem
stenographer	st@`nOgr\@f@
step	step
stepfather	`stepf6:D@
stepladder	`stepl{d@
stepmother	`stepm6D@
stereo	`ster\i:@}
sterile	`ster\Ael
sterilise	`ster\@lAez
stern	st3:n
stethoscope	`steT@sk@}p
stew	stj}:
steward	`stj}:@d
stick	stIk
sticker	`stIk@
sticky	`stIki:
stiff	stIf
stigma	`stIgm@
still	stIl
stimulant	`stImj@l@nt
stimulate	`stImj@l{It
sting	stIN
stingy	`stIndZi:
stink	stINk
stir	st3:
stitch	stItS
stock	stOk
stocking	`stOkIN
stockman	`stOkm@n
stocky	`stOki:
stole	st@}l
stolen	`st@}l@n
stomach	`st6m@k
stone	st@}n
stone-cold	st@}n`k@}ld
stones	st@}nz
stood	stUd
stool	st}:l
stoop	st}:p
stop	stOp
stopover	`stOp@}v@
stopper	`stOp@
storage	`sto:r\IdZ
store	sto:
storey	`sto:r\i:
storm	sto:m
story	`sto:r\i:
stout	st{Ot
stove	st@}v
straggle	str\{g@l
straight	str\{It
straightaway	str\{It@`w{I
straightforward	str\{It`fo:w@d
strain	str\{In
strained	str\{Ind
strand	str\{nd
strange	str\{IndZ
stranger	`str\{IndZ@
strangle	`str\{Ng@l
strap	str\{p
strategic	str\@`ti:dZIk
strategy	`str\{t@dZi:
straw	str\o:
stray	str\{I
streak	str\i:k
stream	str\i:m
streamer	`str\i:m@
street	str\i:t
strength	str\eNkT
strenuous	`str\enj}:@s
stress	str\es
stretch	str\etS
stretched	str\etSt
strew	str\}:
stricken	`str\Ik@n
strict	str\Ikt
stride	str\Aed
strife	str\Aef
strike	str\Aek
striking	`str\AekIN
string	str\IN
strip	str\Ip
stripe	str\Aep
stripper	`str\Ip@
strive	str\Aev
strode	str\@}d
stroke	str\@}k
stroll	str\@}l
stroller	`str\@}l@
strong	str\ON
strove	str\@}v
struck	str\6k
structure	`str\6ktS@
struggle	`str\6g@l
stub	st6b
stubborn	`st6b@n
stubby	`st6bi:
stuck	st6k
stuck-up	`st6k6p
student	`stj}:d@nt
studio	`stj}:di:@}
study	`st6di:
stuff	st6f
stuffing	`st6fIN
stuffy	`st6fi:
stumble	`st6mb@l
stump	st6mp
stumpy	`st6mpi:
stun	st6n
stung	st6N
stunning	`st6nIN
stupid	`stj}:p@d
sturdy	`st3:di:
stutter	`st6t@
style	stAel
stylish	`stAelIS
subdivide	`s6bd@vAed
subdue	s@b`dj}:
subdued	s@b`dj}:d
subject	`s6bdZekt
submarine	`s6bm@r\i:n
submerge	s@b`m3:dZ
submit	s@b`mIt
subordinate	s@b`o:d@n@t
subscribe	s@b`skr\Aeb
subscriber	s@b`skr\Aeb@
subscription	s@b`skr\IpS@n
subsequent	`s6bs@kw@nt
subside	s@b`sAed
subsidiary	s@b`sIdZ@r\i:
subsidy	`s6bs@di:
substance	`s6bst@ns
substantial	s@b`st{nS@l
substitute	`s6bst@tS}:t
subtitle	`s6btAet@l
subtle	`s6t@l
subtract	s@b`tr\{kt
suburb	`s6b3:b
suburbia	s@`b3:bi:@
succeed	s@k`si:d
success	s@k`ses
such	s6tS
suck	s6k
sudden	`s6d@n
suds	s6dz
sue	s}:
suede	sw{Id
suffer	`s6f@
suffering	`s6f@r\IN
sufficient	s@`fIS@nt
suffix	`s6fIks
suffocate	`s6f@k{It
sugar	`SUg@
suggest	s@`dZest
suicidal	s}:@`sAed@l
suicide	`s}:@sAed
suit	s}:t
suitable	`s}:t@b@l
suitcase	`s}:tk{Is
suite	swi:t
suited	`s}:t@d
sulk	s6lk
sullen	`s6l@n
sultana	s6l`t6:n@
sultry	`s6ltr\i:
sum	s6m
summary	`s6m@r\i:
summer	`s6m@
summit	`s6m@t
summon	`s6m@n
summons	`s6m@nz
sumptuous	`s6mptS}:@s
sun	s6n
sunbake	`s6nb{Ik
sunburn	`s6nb3:n
Sunday	`s6nd{I
sundry	`s6ndr\i:
sung	s6N
sunglasses	`s6ngl6:s@z
sunk	s6Nk
sunken	`s6Nk@n
sunlight	`s6nlAet
sunny	`s6ni:
sunrise	`s6nr\Aez
sunscreen	`s6nskr\i:n
sunset	`s6nset
sunshine	`s6nSAen
sunstroke	`s6nstr\@}k
suntan	`s6nt{n
super	`s}:p@
superannuation	`s}:p@r\{nj}:`{IS@n
superb	s@`p3:b
superficial	s}:p@`fIS@l
superintendent	s}:p@r\In`tend@nt
superior	s@`pI@r\i:@
superlative	s@`p3:l@tIv
supermarket	`s}:p@m6:k@t
superstitious	s}:p@`stIS@s
supervise	`s}:p@vAez
supper	`s6p@
supple	`s6p@l
supplement	`s6pl@m@nt
supply	s@`plAe
support	s@`po:t
supportive	s@`po:tIv
suppose	s@`p@}z
supposed	s@`p@}zd
suppress	s@`pr\es
supreme	s@`pr\i:m
sure	So:
surely	`So:li:
surf	s3:f
surface	`s3:f@s
surfboard	`s3:fbo:d
surfing	s3:fIN
surge	s3:dZ
surgeon	`s3:dZ@n
surgery	`s3:dZ@r\i:
surly	`s3:li:
surname	`s3:n{Im
surpass	s@`p6:s
surplus	`s3:pl@s
surprise	s@`pr\Aez
surrender	s@`r\end@
surround	s@`r\{Ond
surroundings	s@`r\{OndINz
survey	s@`v{I
surveyor	s@`v{I@
survive	s@`vAev
Susan	s}:z@n
suspect	s@`spekt
suspend	s@`spend
suspense	s@`spens
suspension	s@`spenS@n
suspicion	s@`spIS@n
suspicious	s@`spIS@s
suss	s6s
sustain	s@`st{In
swag	sw{g
swagger	`sw{g@
swallow	`swOl@}
swam	sw{m
swamp	swOmp
swap	swOp
swarm	swo:m
swarthy	`swo:Di:
swat	swOt
sway	sw{I
swear	swe:
sweat	swet
sweater	`swet@
sweep	swi:p
sweeping	`swi:pIN
sweet	swi:t
sweeten	`swi:t@n
sweetheart	`swi:th6:t
swell	swel
swelling	`swelIN
swept	swept
swerve	sw3:v
swift	swIft
swim	swIm
swimmers	`swIm@z
swimsuit	`swIms}:t
swindle	`swInd@l
swing	swIN
swipe	swAep
switch	swItS
switchboard	`swItSbo:d
switched	swItSt
swollen	`sw@}l@n
swoop	sw}:p
sword	so:d
swore	swo:
sworn	swo:n
swum	sw6m
swung	sw6N
sycamore	sIk@mo:
syllable	`sIl@b@l
syllabus	`sIl@b@s
symbol	`sImb@l
symmetry	`sIm@tr\i:
sympathy	`sImp@Ti:
symphony	`sImf@ni:
symptom	`sImpt@m
synagogue	`sIn@gOg
syndicate	`sInd@k@t
synonym	`sIn@nIm
synopsis	s@`nOps@s
synthetic	sIn`TetIk
syringe	s@`r\IndZ
syrup	`sIr\@p
system	`sIst@m
T	ti:
t	ti:
T-shirt	`ti:S3:t
ta	t6:
tab	t{b
tabby	`t{bi:
table	`t{Ib@l
tablecloth	`t{Ib@lklOT
tablespoon	`t{Ib@lsp}:n
tablet	`t{bl@t
tableware	`t{Ib@lwe:
tabloid	`t{bloId
taboo	t@`b}:
tabulate	`t{bj@l{It
tacit	`t{s@t
taciturn	`t{s@t3:n
tack	t{k
tackle	`t{k@l
tacky	`t{ki:
tact	t{kt
tactic	`t{ktIk
tactics	`t{ktIks
TAFE	t{If
tag	t{g
tail	t{Il
tailor	`t{Il@
taipan	`tAep{n
take	t{Ik
take-off	`t{IkOf
takeaway	`t{Ik@w{I
taken	t{Ik@n
takings	`t{IkINz
tale	t{Il
talent	`t{l@nt
talk	to:k
talkback	`to:kb{k
tall	to:l
tally	`t{li:
talon	`t{l@n
tame	t{Im
tamper	`t{mp@
tampon	`t{mpOn
tan	t{n
tandem	`t{nd@m
tang	t{N
tangent	`t{ndZ@nt
tangerine	t{ndZ@`r\i:n
tangible	`t{ndZ@b@l
tangle	`t{Ng@l
tank	t{Nk
tankard	`t{Nk@d
tanker	`t{Nk@
tantalise	`t{nt@lAez
tantamount	`t{nt@m{Ont
tantrum	`t{ntr\@m
tap	t{p
tape	t{Ip
tape-recorder	`t{Ipr\@ko:d@
taper	`t{Ip@
tapestry	`t{p@str\i:
tar	t6:
target	`t6:g@t
tariff	`t{r\@f
tarmac	`t6:m{k
tarnish	`t6:nIS
tarpaulin	t6:`po:l@n
tarragon	`t{r\@g@n
tart	t6:t
tartan	`t6:t@n
Tas.	t{z`m{Ini:@
task	t6:sk
tassel	`t{s@l
taste	t{Ist
tasteful	`t{IstfUl
tasteless	`t{Istl@s
tasty	`t{Isti:
tattered	`t{t@d
tatters	`t{t@z
tattoo	t{`t}:
tatty	`t{ti:
taught	to:t
taunt	to:nt
taut	to:t
tautology	to:`tOl@dZi:
tavern	`t{v@n
taw	to:
tawdry	`to:dr\i:
tawny	`to:ni:
tax	t{ks
taxi	`t{ksi:
tea	ti:
teabag	`ti:b{g
teach	ti:tS
teacher	`ti:tS@
team	ti:m
teapot	`ti:pOt
tear	tI@
tearing	te:r\IN
tears	tI@z
tease	ti:z
teaspoon	`ti:sp}:n
teat	ti:t
tech	tek
technical	`teknIk@l
technician	tek`nIS@n
technique	tek`ni:k
technology	tek`nOl@dZi:
tedious	`ti:di:@s
tee	ti:
teem	ti:m
teenager	`ti:n{IdZ@
teens	ti:nz
teeth	ti:T
teetotal	`ti:t@}t@l
telecast	`tel@k6:st
telecommunications	tel@k@mj}:n@`k{IS@ns
telepathy	t@`lep@Ti:
telephone	`tel@f@}n
telescope	`tel@sk@}p
television	`tel@vIZ@n
tell	tel
teller	`tel@
temper	`temp@
temperament	`tempr\@m@nt
temperamental	tempr\@`ment@l
temperature	`tempr\@tS@
temporary	`tempr\i:
tempt	tempt
tempting	temptIN
ten	ten
tenacious	t@`n{IS@s
tenant	`ten@nt
tend	tend
tended	tend@d
tender	`tend@
tendon	`tend@n
tenement	`ten@m@nt
tennis	`ten@s
tenor	`ten@
tense	tens
tent	tent
tentacle	`tent@k@l
tentative	`tent@tIv
tenth	tenT
tenuous	`tenj}:@s
tepid	`tep@d
term	t3:m
terminal	`t3:m@n@l
terminate	`t3:m@n{It
terminology	t3:m@`nOl@dZi:
terminus	`t3:m@n@s
termite	`t3:mAet
terrace	`ter\@s
terrain	t@`r\{In
terrestrial	t@`r\estr\i:@l
terrible	`ter\@b@l
terribly	`ter\@bli:
terriers	ter\i:@z
terrific	t@`r\IfIk
terrify	`ter\@fAe
territory	`ter\@tr\i:
terror	`ter\@
terrorise	`ter\@r\Aez
terrorism	`ter\@r\Iz@m
terse	t3:s
tertiary	`t3:S@r\i:
test	test
testament	`test@m@nt
testicle	`testIk@l
testify	`test@fAe
testimonial	test@`m@}ni:@l
testimony	`test@m@ni:
tether	`teD@
text	tekst
texta	`tekst@
textbook	`tekstbUk
textile	`tekstAel
texture	`tekstS@
Thai	tAe
than	D{n
thank	T{Nk
that	D{t
thatch	T{tS
thaw	To:
the	D@
theatre	`TI@t@
theatrical	Ti:`{tr\Ik@l
theft	Teft
their	De:
theirs	De:z
them	Dem
theme	Ti:m
themselves	D@m`selvz
then	Den
theology	Ti:`Ol@dZi:
theorem	`TI@r\@m
theory	`TI@r\i:
therapeutic	Ter\@`pj}:tIk
therapy	`Ter\@pi:
there	De:
there'll	De:l
thereabouts	De:r\@`b{Ots
thereafter	De:r\`6:ft@
thereby	De:`bAe
therefore	`De:fo:
therell	De:l
thereupon	De:r\@`pOn
thermometer	T@`mOm@t@
thermos	`T3:mOs
thermostat	`T3:m@st{t
thesaurus	T@`so:r\@s
these	Di:z
thesis	`Ti:s@s
they	D{I
thick	TIk
thicket	`TIk@t
thief	Ti:f
thigh	TAe
thimble	`TImb@l
thin	TIn
thing	TIN
think	TINk
third	T3:d
thirst	T3:st
thirteen	T3:`ti:n
thirteenth	T3:`ti:nT
thirty	`T3:ti:
this	DIs
thistle	`TIs@l
thong	TON
thorn	To:n
thorough	`T6r\@
thoroughfare	`T6r\@fe:
thoroughly	`T6r\@li:
those	D@}z
though	D@}
thought	To:t
thoughtful	`To:tfUl
thoughtless	`To:tl@s
thousand	`T{Oz@nd
thousandth	`T{Oz@nT
thrash	Tr\{S
thread	Tr\ed
threadbare	`Tr\edbe:
threat	Tr\et
threaten	`Tr\et@n
three	Tr\i:
three-dimensional	Tr\i:d@`menS@n@l
thresh	Tr\eS
threshold	`Tr\eSh@}ld
threw	Tr\}:
thrift	Tr\Ift
thrifty	Tr\Ifti:
thrill	Tr\Il
thriller	`Tr\Il@
thrive	Tr\Aev
throat	Tr\@}t
throb	Tr\Ob
throne	Tr\@}n
throng	Tr\ON
throttle	`Tr\Ot@l
through	Tr\}:
throughout	Tr\}:`{Ot
throw	Tr\@}
thrust	Tr\6st
thud	T6d
thug	T6g
thumb	T6m
thump	T6mp
thunder	`T6nd@
Thursday	`T3:zd{I
thus	D6s
thwart	Two:t
thyme	tAem
thyroid	`TAer\oId
tick	tIk
ticket	`tIk@t
tickle	`tIk@l
ticklish	`tIklIS
tiddly	`tIdli:
tide	tAed
tidy	`tAedi:
tie	tAe
tier	`tI@
tiger	tAeg@
tight	tAet
tights	tAets
tile	tAel
till	tIl
tilt	tIlt
tilts	tIlts
timber	`tImb@
time	tAem
timely	`tAemli:
timetable	`tAemt{Ib@l
timid	`tIm@d
tin	tIn
tinea	`tIni:@
tinge	tInZ
tingle	`tINg@l
tinker	`tINk@
tinkle	`tINk@l
tinnie	`tIni:
tinny	`tIni:
tinsel	`tIns@l
tint	tInt
tiny	`tAeni:
tip	tIp
tipsy	`tIpsi:
tirade	tAe`r\{Id
tire	tAe@
tired	tAe@d
tiring	`tAe@r\IN
tissue	`tIS}:
tit	tIt
titbit	`tItbIt
title	`tAet@l
titter	`tIt@
to	t}:
toad	t@}d
toadstool	`t@}dst}:l
toast	t@}st
toaster	`t@}st@
tobacco	t@`b{k@}
toboggan	t@`bOg@n
today	t@`d{I
toddle	`tOd@l
toddler	`tOdl@
toe	t@}
together	t@`geD@
toil	toIl
toilet	`toIl@t
toiletries	`toIl@tr\i:z
token	`t@}k@n
told	t@}ld
tolerable	`tOl@r\@b@l
tolerant	`tOl@r\@nt
tolerate	`tOl@r\{It
toll	tOl
tomato	t@`m6:t@}
tomb	t}:m
tombstone	`t}:mst@}n
tomcat	`tOmk{t
tomorrow	t@`mOr\@}
ton	t6n
tone	t@}n
tongue	t6N
tonic	`tOnIk
tonight	t@`nAet
tonne	tOn
tonsil	`tOns@l
tonsilitis	tOns@`lAet@s
too	t}:
took	tUk
tool	t}:l
toot	t}:t
tooth	t}:T
toothache	`t}:T{Ik
toothbrush	`t}:Tbr\6S
toothpaste	`t}:Tp{Ist
toothpick	`t}:TpIk
top	tOp
topic	`tOpIk
topical	`tOpIk@l
topless	`tOpl@s
topping	`tOpIN
topple	`tOp@l
torch	to:tS
tore	to:
torment	`to:ment
torn	to:n
tortuous	`to:tS}:@s
torture	`to:tS@
toss	tOs
total	`t@}t@l
totalitarian	t@}t{l@`te:r\i:@n
totem	`t@}t@m
totter	`tOt@
touch	t6tS
touchy	`t6tSi:
tough	t6f
tour	tU@
tourism	`tU@r\Iz@m
tourist	`tU@r\@st
tourists	t}:r\@sts
tournament	`to:n@m@nt
tow	t@}
towards	t@`wo:dz
towel	`t{O@l
tower	t{O@
town	t{On
toxic	`tOksIk
toxin	`tOks@n
toy	toI
trace	tr\{Is
track	tr\{k
tracksuit	`tr\{ks}:t
tractor	`tr\{kt@
trade	tr\{Id
trade-in	`tr\{IdIn
trademark	`tr\{Idm6:k
tradition	tr\@`dIS@n
traffic	`tr\{fIk
tragedy	`tr\{dZ@di:
tragic	`tr\{dZIk
trail	tr\{Il
trailer	`tr\{Il@
train	tr\{In
trainee	tr\{I`ni:
training	`tr\{InIN
trait	tr\{It
traitor	`tr\{It@
tram	tr\{m
trample	`tr\{mp@l
tranquil	`tr\{Nkw@l
tranquilliser	`tr\{Nkw@lAez@
transfer	tr\{ns`f3:
transform	tr\{ns`fo:m
transfusion	tr\{ns`fj}:Z@n
transitive	`tr\{ns@tIv
translate	tr\{nz`l{It
transmit	tr\{nz`mIt
transparent	tr\{nz`pe:r\@nt
transplant	tr\{ns`pl{nt
transport	`tr\{nspo:t
trap	tr\{p
trauma	`tr\o:m@
travel	`tr\{v@l
tray	tr\{I
treacherous	`tr\etS@r\@s
treachery	`tr\etS@r\i:
tread	tr\ed
treasure	`tr\eZ@
treasurer	`tr\eZ@r\@
treat	tr\i:t
tree	tr\i:
tremble	`tr\emb@l
tremendous	tr\@`mend@s
trend	tr\end
trendy	`tr\endi:
trespass	`tr\esp@s
trial	tr\Ae@l
triangle	`tr\Ae{Ng@l
tribunal	tr\@`bj}:n@l
trick	tr\Ik
trickle	`tr\Ik@l
tried	tr\Aed
trifle	tr\Aef@l
trim	tr\Im
trip	tr\Ip
triple	`tr\Ip@l
triumph	`tr\Ae6mf
trivial	`tr\Ivi:@l
trod	tr\Od
trodden	`tr\Od@n
trolley	`tr\Oli:
troop	tr\}:p
tropical	`tr\OpIk@l
tropics	`tr\OpIks
trouble	`tr\6b@l
trousers	`tr\{Oz@z
trout	tr\{Ot
Troy	tr\oI
truck	tr\6k
trudge	tr\6dZ
true	tr\}:
trumpet	`tr\6mp@t
trunk	tr\6Nk
trust	tr\6st
trustworthy	`tr\6stw3:Di:
truth	tr\}:T
truthful	`tr\}:TfUl
try	tr\Ae
tube	tj}:b
tuck	t6k
Tuesday	`tj}:zd{I
tuft	t6ft
tug	t6g
tuition	tj}:`IS@n
tumble	`t6mb@l
tumour	`tj}:m@
tuna	`tj}:n@
tune	tj}:n
tuner	tS}:n@
tunnel	`t6n@l
Turkish	`t3:kIS
turn	t3:n
turquoise	`t3:kwoIz
tutor	`tj}:t@
TV	ti:`vi:
tweezers	`twi:z@z
twelfth	twelfT
twelve	twelv
twentieth	`twenti:@T
twenty	`twenti:
twice	twAes
twig	twIg
twilight	`twAelAet
twin	twIn
twinge	twIndZ
twinkle	`twINk@l
twins	twInz
twist	twIst
two	t}:
tying	`tAeIN
type	tAep
typewriter	`tAepr\Aet@
typhoid	`tAefoId
typhoon	tAe`f}:n
typical	`tIpIk@l
typically	`tIpIkli:
tyre	tAe@
U	j}:
u	j}:
ugly	`6gli:
ulcer	`6ls@
ultimate	`6lt@m@t
um	6m
umbrella	6m`br\el@
umpire	`6mpAe@
umpteen	6mp`ti:n
unanimous	j}:`n{n@m@s
uncanny	6n`k{ni:
uncle	`6Nk@l
unconscious	6n`kOnS@s
uncontrollable	6nk@ntr\@}l@b@l
under	`6nd@
underarm	`6nd@r\6:m
underdone	6nd@`d6n
undergo	6nd@`g@}
undergrowth	`6nd@gr\@}T
underhand	`6nd@h{nd
underline	6nd@`lAen
underneath	6nd@`ni:T
underpants	`6nd@p{nts
understand	6nd@`st{nd
understate	6nd@`st{It
undertake	6nd@`t{Ik
undertaker	`6nd@t{Ik@
underwear	`6nd@we:
undo	6n`d}:
uneasy	6n`i:zi:
unemployed	6n@m`ploId
uneventful	6n@`ventfUl
unforgettable	6nf@`get@b@l
unfortunately	6nfo:tS@n@tli:
uniform	`j}:n@fo:m
unify	`j}:n@fAe
unilateral	j}:ni:`l{t@r\@l
uninterested	6n`Intr\@st@d
union	`j}:nj@n
unique	j}:`ni:k
unisex	`j}:ni:seks
unison	`j}:n@s@n
unit	`j}:n@t
unite	j}:`nAet
universal	j}:n@`v3:s@l
universe	`j}:n@v3:s
university	j}:n@`v3:s@ti:
unknown	6n`n@}n
unlawful	6n`lo:fUl
unless	6n`les
unravel	6n`r\{v@l
unreal	6n`r\i:l
unrest	6n`r\est
unscathed	6n`sk{IDd
unscrew	6n`skr\}:
unscrupulous	6n`skr\}:pj@l@s
unsettle	6n`set@l
untangle	6n`t{Ng@l
unthinkable	6n`TINk@b@l
untie	6n`tAe
until	6n`tIl
unusual	6n`j}:Z}:@l
unwieldy	6n`wI@ldi:
up	6p
up-market	`6pm6:k@t
up-to-date	6pt@`d{It
upbringing	`6pbr\ININ
update	6p`d{It
upgrade	6p`gr\{Id
upheaval	6p`hi:v@l
uphill	6p`hIl
uphold	6p`h@}ld
upholstery	6p`h@}lstr\i:
upkeep	`6pki:p
upon	@`pOn
upper	`6p@
uppermost	`6p@m@}st
upright	`6pr\Aet
uprising	`6pr\AezIN
uproar	`6pr\o:
uproarious	6p`r\o:r\i:@s
upset	6p`set
upstairs	6p`ste:z
upstream	6p`str\i:m
uptight	6p`tAet
upturn	`6pt3:n
upward	`6pw@d
upwards	`6pw@dz
upwind	6p`wInd
uranium	j}:`r\{Ini:@m
urban	`3:b@n
urbane	3:`b{In
urge	3:dZ
urgent	`3:dZ@nt
urinal	`j}:r\@n@l
urine	`j}:r\@n
urn	3:n
us	6s
use	j}:z
used	j}:zd
usual	`j}:Z}:@l
ute	j}:t
utensil	j}:`tens@l
uterus	`j}:t@r\@s
utilities	j}:`tIl@ti:z
utter	`6t@
V	vi:
v	`v3:s@z
vacancy	`v{Ik@nsi:
vacant	`v{Ik@nt
vacation	v{I`k{IS@n
vaccine	`v{ksi:n
vacuum	`v{kj}:m
vagina	v@`dZAen@
vague	v{Ig
vain	v{In
valid	`v{l@d
valley	`v{li:
valuable	`v{lj@b@l
value	`v{lj}:
valve	v{lv
van	v{n
vandal	`v{nd@l
vanilla	v@`nIl@
vanish	`v{nIS
vanity	`v{n@ti:
vapour	`v{Ip@
variety	v@`r\Ae@ti:
various	`ve:r\i:@s
varnish	`v6:nIS
vary	`ve:r\i:
vase	v6:z
vast	v6:st
vat	v{t
VCR	vi:si:`6:
VDU	vi:di:`j}:
veal	vi:l
vegan	`vi:g@n
vegemite	vedZ@mAet
vegetable	`vedZt@b@l
vegetarian	vedZ@`te:r\i:@n
vegetation	vedZ@`t{IS@n
vegie	`vedZi:
vehement	`vi:@m@nt
vehicle	`vI@k@l
veil	v{Il
vein	v{In
velvet	`velv@t
veneer	v@`nI@
vengeance	`vendZ@ns
venom	`ven@m
ventilate	`vent@l{It
venture	`ventS@
venue	`venj}:
veranda	v@`r\{nd@
verb	v3:b
verbal	`v3:b@l
verdict	`v3:dIkt
verify	`ver\@fAe
versatile	`v3:s@tAel
verse	v3:s
version	`v3:Z@n
versus	`v3:s@z
vertebra	`v3:t@br\@
vertical	`v3:tIk@l
very	`ver\i:
vessel	`ves@l
vet	vet
veto	`vi:t@}
vex	veks
via	`vAe@
vibrate	vAe`br\{It
Vic.	vIk`to:r\i:@
vice	vAes
vicinity	v@`sIn@ti:
vicious	`vIS@s
victim	`vIkt@m
victimise	`vIkt@mAez
victory	`vIktr\i:
video	`vIdi:@}
videotape	`vIdi:@}t{Ip
Vietnamese	vi:etn@`mi:z
view	vj}:
viewer	`vj}:@
vigorous	`vIg@r\@s
vile	vAel
village	`vIlIdZ
villain	`vIl@n
vindictive	vIn`dIktIv
vine	vAen
vinegar	`vInIg@
vineyard	`vInj@d
vintage	`vIntIdZ
vinyl	`vAen@l
violent	`vAe@l@nt
violently	vAel@ntli:
violin	vAe@`lIn
VIP	vi:Ae`pi:
virgin	`v3:dZ@n
virile	`vIr\Ael
virtue	`v3:tS}:
virulent	`vIr\@l@nt
virus	`vAer\@s
visa	`vi:z@
visible	`vIz@b@l
vision	`vIZ@n
visit	`vIz@t
visual	`vIZ}:@l
visualise	`vIZj@lAez
vital	`vAet@l
vitality	vAe`t{l@ti:
vitamin	`vAet@m@n
vivacious	v@`v{IS@s
vivid	`vIv@d
vocabulary	v@`k{bj@l@r\i:
vocal	`v@}k@l
vocalist	`v@}k@l@st
vogue	v@}g
voice	voIs
void	voId
volcano	vOl`k{In@}
volley	`vOli:
volleyball	`vOli:bo:l
volume	`vOlj}:m
voluntary	`vOl@ntr\i:
volunteer	vOl@n`tI@
vomit	`vOm@t
voodoo	v}:d}:
vote	v@}t
voucher	`v{OtS@
vow	v{O
vowed	v{Od
vowel	`v{O@l
voyage	`voIIdZ
vs	`v3:s@z
vulgar	`v6lg@
vulnerable	`v6lnr\@b@l
W	west
w	`d6b@lj}:
WA	west@n@`str\{Ilj@
wad	wOd
waddle	`wOd@l
wade	w{Id
wafer	`w{If@
wag	w{g
wage	w{IdZ
wager	`w{IdZ@
wagon	w{g@n
wail	w{Il
waist	w{Ist
wait	w{It
waiter	`w{It@
waiting	w{ItIN
wake	w{Ik
walk	wo:k
walkover	`wo:k@}v@
wall	wo:l
wallet	`wOl@t
wallpaper	`wo:lp{Ip@
waltz	wo:lts
wander	`wOnd@
wane	w{In
wangle	`w{Ng@l
wank	w{nk
want	wOnt
wanted	wOnt@d
war	wo:
ward	wo:d
warden	`wo:d@n
warder	`wo:d@
wardrobe	`wo:dr\@}b
warehouse	`we:h{Os
warfare	`wo:fe:
warm	wo:m
warn	wo:n
warning	`wo:nIN
warp	wo:p
warped	wo:pt
warrant	`wOr\@nt
warranty	`wOr\@nti:
wart	wo:t
wary	`we:r\i:
was	wOz
wash	wOS
washed-out	`wOSt{Ot
washer	`wOS@
waste	w{Ist
watch	wOtS
watched	wOtSt
water	`wo:t@
watercolour	`wo:t@k6l@
waterfront	`wo:t@fr\6nt
waterlogged	`wo:t@lOgd
waterproof	`wo:t@pr\}:f
waterski	`wo:t@ski:
watertight	`wo:t@tAet
watt	wOt
wattle	`wOt@l
wave	w{Iv
wax	w{ks
way	w{I
way-out	`w{I{Ot
we	wi:
we'd	wi:d
we're	we:
weak	wi:k
wealth	welT
wealthy	`welTi:
weapon	`wep@n
wear	we:
weary	`wI@r\i:
weather	`weD@
weave	wi:v
web	web
webbed	webd
wedding	`wedIN
wedge	wedZ
Wednesday	`wenzd{I
weed	wi:d
week	wi:k
weekday	`wi:kd{I
weekend	wi:k`end
weekly	`wi:kli:
weep	wi:p
weigh	w{I
weight	w{It
weird	wI@d
welcome	`welk@m
weld	weld
welfare	`welfe:
well	wel
well-off	wel`Of
wellbeing	`welbi:IN
went	went
wept	wept
were	w3:
werent	w3:nt
west	west
western	`west@n
wet	wet
whack	w{k
wharf	wo:f
what	wOt
whatever	wOt`ev@
whatsoever	wOts@}`ev@
wheat	wi:t
wheel	wi:l
wheelbarrow	`wi:lb{r\@}
wheelchair	`wi:ltSe:
when	wen
whenever	wen`ev@
where	we:
whereabouts	`we:r\@b{Ots
whereas	we:r\`{z
wherever	we:r\`ev@
whether	`weD@
which	wItS
whiff	wIf
while	wAel
whilst	wAelst
whim	wIm
whimper	`wImp@
whine	wAen
whinge	wIndZ
whip	wIp
whirl	w3:l
whirlwind	`w3:lwInd
whirr	w3:
whisk	wIsk
whisker	`wIsk@
whisky	`wIski:
whisper	`wIsp@
whistle	`wIs@l
white	wAet
white-ant	`wAet{nt
white-out	`wAet{Ot
whitewash	`wAetwOS
whiz	wIz
who	h}:
who'd	h}:d
who'll	h}:l
whod	h}:d
whoever	h}:`ev@
whole	h@}l
wholemeal	`h@}lmi:l
wholesale	`h@}ls{Il
wholesome	`h@}ls@m
wholl	h}:l
whom	h}:m
whopping	`wOpIN
whore	ho:
whose	h}:z
why	wAe
wick	wIk
wicked	`wIk@d
wicket	`wIk@t
wide	wAed
widespread	`wAedspr\ed
widow	`wId@}
widower	`wId@}@
wife	wAef
wig	wIg
wiggle	`wIg@l
wild	wAeld
wilderness	`wIld@nes
wildlife	`wAeldlAef
wilful	`wIlfUl
will	wIl
willing	`wIlIN
willpower	`wIlp{O@
wilt	wIlt
wily	`wAeli:
wimp	wImp
win	wIn
wince	wIns
wind	wInd
window	`wInd@}
windows	wInd@}z
windowsill	`wInd@}sIl
windpipe	`wIndpAep
windscreen	`wIndskr\i:n
windsurf	`wInds3:f
windy	`wIndi:
wine	wAen
wing	wIN
wink	wINk
winning	`wInIN
winter	`wInt@
wipe	wAep
wire	`wAe@
wiry	`wAe@r\i:
wise	wAez
wish	wIS
wishy-washy	`wISi:wOSi:
wit	wIt
witch	wItS
with	wIT
withdraw	wID`dr\o:
withhold	wID`h@}ld
within	wID`In
without	wID`{Ot
witness	`wItn@s
wizard	`wIz@d
wobble	`wOb@l
woe	w@}
woeful	`w@}fUl
wog	wOg
wok	wOk
woke	w@}k
wolf	wUlf
woman	`wUm@n
womb	w}:m
wombat	`wOmb{t
won	w6n
wonder	`w6nd@
wonderful	`w6nd@fUl
wood	wUd
wooden	wUd@n
woodwork	`wUdw3:k
wool	wUl
Word	Pronunciation
word	w3:d
wore	wo:
work	w3:k
workbench	`w3:kbentS
workforce	`w3:kfo:s
workload	`w3:kl@}d
workout	`w3:k{Ot
workplace	`w3:kpl{Is
workshop	`w3:kSOp
world	w3:ld
worldwide	w3:ld`wAed
worm	w3:m
worn	wo:n
worn-out	wo:n`{Ot
worry	`w6r\i:
worse	w3:s
worship	`w3:SIp
worst	w3:st
worth	w3:T
worthwhile	w3:T`wAel
worthy	`w3:Di:
would	wUd
wound	w{Ond
woven	`w@}v@n
wow	w{O
wowser	`w{Oz@
Wran	r\{n
wrap	r\{p
wreath	r\i:T
wreck	r\ek
wren	r\en
wrestle	`r\es@l
wretch	r\etS
wriggle	`r\Ig@l
wring	r\IN
wrinkle	`r\INk@l
wrist	r\Ist
write	r\Aet
write-off	`r\AetOf
wrong	r\ON
wrote	r\@}t
wrung	r\6N
wuss	wUs
X	eks
x	eks
x-ray	`eksr\{I
Xmas	`kr\Ism@s
Y	wAe
y	wAe
yacht	jOt
yak	j{k
yakka	`j{k@
yank	j{Nk
yap	j{p
yard	j6:d
yarn	j6:n
yawn	jo:n
yd	j6:d
yeah	je:
year	jI@
yeast	ji:st
yell	jel
yellow	`jel@}
yelp	jelp
yen	jen
yes	jes
yesterday	`jest@d{I
yet	jet
yield	ji:ld
yoga	`j@}g@
yoghurt	`j@}g@t
yolk	j@}k
yonks	jONks
you	j}:
you'll	j}:l
young	j6N
youngster	`j6Nst@
your	jo:
yours	jo:z
yourself	jo:`self
youth	j}:T
yr	jI@
yuk	j6k
yuppie	`j6pi:
Z	zed
z	zed
zeal	zi:l
zero	`zI@r\@}
zest	zest
zigzag	`zIgz{g
zinc	zINk
zip	zIp
zodiac	`z@}di:{k
zombie	`zOmbi:
zone	z@}n
zoo	z}:
zoology	z@}`Ol@dZi:
zoom	z}:m
zucchini	z@`ki:ni:
