tie	tAe	tAe
dump	d6mp	d6mp
gesture	dZestS@	dZestS@
item	Aet@m	Aet@m
some	s6m	s6m
syndicate	sIndIk@t	sInd@k@t
barracks	b{r\@ks	b{r\@ks
implicit	ImplIs@t	ImplIs@t
earn	@:n	3:n
preposterous	pr\@pOstr\@s	pr\@pOstr\@s
chill	tSIl	tSIl
runway	r\6nw{I	r\6nw{I
assassin	@s{s@n	@s{s@n
favour	f{Iv@	f{Iv@
diameter	dAe{m@t@	dAe{m@t@
sat	s{t	s{t
melanoma	mel@n@}m@	mel@n@}m@
CES	si:i:es	si:i:es
cripple	kr\Ip@l	kr\Ip@l
post-mortem	p@}st-m@:t@m	p@}stmo:t@m
boilersuit	b@:Il@s}:t	boIl@s}:t
bead	bi:d	bi:d
florist	flOr\@st	flOr\@st
prosecute	pr\Os@kj}:t	pr\Os@kj}:t
blitz	blIts	blIts
hidden	hIdn	hId@n
chirpy	tS@:pi:	tS3:pi:
aerodrome	e@r\@dr\@}m	e:r\@dr\@}m
sensible	sens@b@l	sens@b@l
review	r\@vj}:	r\@vj}:
nettle	netl	net@l
tenant	ten@nt	ten@nt
suffer	s6f@	s6f@
embroider	embr\@:Ud@	embr\oId@
modify	mOd@fAe	mOd@fAe
rally	r\{li:	r\{li:
progress	pr\@}gr\es	pr\@}gr\es
conception	k@nsepS@n	k@nsepS@n
P-plate	pi:-pl{It	pi:pl{It
mood	m}:d	m}:d
hobble	hOb@l	hOb@l
tenor	ten@	ten@
sixth	sIksT	sIksT
anatomy	@n{t@mi:	@n{t@mi:
girlfriend	g@:lfr\end	g3:lfr\end
litterbug	lIt@b6g	lIt@b6g
sweep	swi:p	swi:p
sick	sIk	sIk
skip	skIp	skIp
predominant	pr\@dOm@n@nt	pr\@dOm@n@nt
bitumen	bItS@m@n	bItS@m@n
cossie	kOzi:	kOzi:
elevate	el@v{It	el@v{It
judo	dZ}:d@}	dZ}:d@}
cake	k{Ik	k{Ik
feel	fi:l	fi:l
diligent	dIl@dZ@nt	dIl@dZ@nt
gain	g{In	g{In
hear	hI@	hI@
platform	pl{tf@:m	pl{tfo:m
foreman	f@:m@n	fo:m@n
cerebral	ser\@br\@l	ser\@br\@l
process	pr\@}ses	pr\@}ses
brainwave	br\{Inw{Iv	br\{Inw{Iv
trainee	tr\{Ini:	tr\{Ini:
nil	nIl	nIl
spooky	sp}:ki:	sp}:ki:
ghetto	get@}	get@}
strode	str\@}d	str\@}d
savour	s{Iv@	s{Iv@
greenhouse	gr\i:nh{Os	gr\i:nh{Os
calorie	k{l@r\i:	k{l@r\i:
teapot	ti:pOt	ti:pOt
sincere	sInsI@	sInsI@
despise	d@spAez	d@spAez
flue	fl}:	fl}:
thirty	T@:ti:	T3:ti:
slang	sl{N	sl{N
pancake	p{Nk{Ik	p{Nk{Ik
warranty	wOr\@nti:	wOr\@nti:
horticulture	h@:t@k6ltS@	ho:t@k6ltS@
Cross	kr\Os	kr\Os
cuff	k6f	k6f
sin	sIn	sIn
bread-and-butter	br\ed-@n-b6t@	br\ed@nb6t@
dividend	dIv@dend	dIv@dend
hymn	hIm	hIm
disposable	dIsp@}z@bl	d@sp@}z@b@l
spiritual	spIr\ItS}:@l	spIr\@tS@l
fireproof	fAe@pr\}:f	fAe@pr\}:f
await	@w{It	@w{It
workforce	w@:kf@:s	w3:kfo:s
stuck-up	st6k-6p	st6k6p
agree	@gr\i:	@gr\i:
woodwork	wUdw@:k	wUdw3:k
fence	fens	fens
limestone	lAemst@}n	lAemst@}n
amend	@mend	@mend
resent	r\@zent	r\@zent
