four	f@:	fo:
pardon	p6:dn	p6:d@n
quadruple	kw@dr\}:p@l	kwOdr\}:p@l
lord	l@:d	lo:d
hormone	h@:m@}n	ho:m@}n
impertinent	Imp@:t@n@nt	Imp3:t@n@nt
disturb	d@st@:b	d@st3:b
avert	@v@:t	@v3:t
dog-ear	dOg-I@	dOgI@
reporter	r\@p@:t@	r\@po:t@
herb	h@:b	h3:b
herd	h@:d	h3:d
dork	d@:k	do:k
controversy	kOntr\@v@:si:	kOntr\@v3:si:
brought	br\@:t	br\o:t
stern	st@:n	st3:n
therefore	De@f@:	De:fo:
passport	p6:sp@:t	p6:spo:t
hurt	h@:t	h3:t
hurl	h@:l	h3:l
sweeten	swi:tn	swi:t@n
house-warming	h{Os-w@:mIN	h{Oswo:mIN
turn	t@:n	t3:n
dimple	dImpl	dImp@l
short-tempered	S@:t-temp@d	So:ttemp@d
headquarters	hedkw@:t@z	hedkwo:t@z
vary	ve@r\i:	ve:r\i:
bread-and-butter	br\ed-@n-b6t@	br\ed@nb6t@
hidden	hIdn	hId@n
bristle	br\Isl	br\Is@l
hyped-up	hAept-6p	hAept6p
fortnight	f@:tnAet	fo:tnAet
borne	b@:n	bo:n
misfortune	mIsf@:tS@n	mIsfo:tS@n
smirk	sm@:k	sm3:k
broad-minded	br\@:d-mAend@d	br\o:dmAend@d
outburst	{Otb@:st	{Otb3:st
waddle	wOdl	wOd@l
chlorine	kl@:r\i:n	klo:r\i:n
enormous	@n@:m@s	@no:m@s
disturbed	d@st@:bd	d@st3:bd
whirlwind	w@:lwInd	w3:lwInd
basketball	b6:sk@tb@:l	b6:sk@tbo:l
service	s@:v@s	s3:v@s
crawl	kr\@:l	kr\o:l
idle	Aedl	Aed@l
headland	hedl@nd	hedl{nd
corny	k@:ni:	ko:ni:
thaw	T@:	To:
wholesome	h@}ls6m	h@}ls@m
person	p@:s@n	p3:s@n
disjointed	dIsdZ@:Int@d	dIsdZoInt@d
press-up	pr\es-6p	pr\es6p
temperamental	tempr\@mentl	tempr\@ment@l
incorporate	INk@:p@r\{It	INko:p@r\{It
chirpy	tS@:pi:	tS3:pi:
doublecross	d6blkr\Os	d6b@lkr\Os
foremost	f@:m@}st	fo:m@}st
altogether	@:lt@geD@	o:lt@geD@
boarder	b@:d@	bo:d@
release	r\@lIs	r\@li:s
disaster	dIz6:st@	d@z6:st@
fair	fe@	fe:
heirloom	e@l}:m	e:l}:m
nocturnal	nOkt@:n@l	nOkt3:n@l
alternative	Olt@:n@tIv	Olt3:n@tIv
irk	@:k	3:k
scorn	sk@:n	sko:n
preserve	pr\@z@:v	pr\@z3:v
freeze-dry	fr\i:z-dr\Ae	fr\i:zdr\Ae
mortified	m@:t@fAed	mo:t@fAed
hers	h@:z	h3:z
commerce	kOm@:s	kOm3:s
by-election	bAe-@lekS@n	bAe@lekS@n
dissect	dIsekt	d@sekt
brainstorm	br\{Inst@:m	br\{Insto:m
employ	empl@:I	emploI
flea-bitten	fli:-bItn	fli:bIt@n
memorial	m@m@:r\i:@l	m@mo:r\i:@l
swarthy	sw@:Di:	swo:Di:
drop-out	dr\Op-{Ot	dr\Op{Ot
fairly	fe@li:	fe:li:
half-sister	h6:f-sIst@	h6:fsIst@
typhoid	tAef@:Id	tAefoId
workforce	w@:kf@:s	w3:kfo:s
boiler	b@:Il@	boIl@
disguise	dIsgAez	d@sgAez
watercolour	w@:t@k6l@	wo:t@k6l@
topical	tOpIkl	tOpIk@l
falter	f@:lt@	fo:lt@
birth	b@:T	b3:T
pertinent	p@:t@n@nt	p3:t@n@nt
crematorium	kr\em@t@:r\i:@m	kr\em@to:r\i:@m
sure	S@:	So:
billboard	bIlb@:d	bIlbo:d
for	f@:	fo:
rehearse	r\@h@:s	r\@h3:s
tertiary	t@:S@r\i:	t3:S@r\i:
despair	d@spe@	d@spe:
meddle	medl	med@l
gauze	g@:z	go:z
respectable	r\@spekt@bl	r\@spekt@b@l
Governor-General	g6v@n@-dZenr\@l	g6v@n@dZenr\@l
call	k@:l	ko:l
thesaurus	T@s@:r\@s	T@so:r\@s
straggle	str\{gl	str\{g@l
after-effect	6:ft@r\-@fekt	6:ft@r\@fekt
tournament	t@:n@m@nt	to:n@m@nt
floor	fl@:	flo:
circumcise	s@:k@msAez	s3:k@msAez
ointment	@:Intm@nt	oIntm@nt
warn	w@:n	wo:n
twinkle	twINkl	twINk@l
per	p@:	p3:
convoy	kOnv@:I	kOnvoI
chair	tSe@	tSe:
jerk	dZ@:k	dZ3:k
choice	tS@:Is	tSoIs
mourn	m@:n	mo:n
settle	setl	set@l
record-player	r\ek@:d-pl{I@	r\eko:dpl{I@
wherever	we@r\ev@	we:r\ev@
prefer	pr\@f@:	pr\@f3:
August	@:g@st	o:g@st
afford	@f@:d	@fo:d
abortion	@b@:S@n	@bo:S@n
immune	Imj}:n	@mj}:n
laundry	l@:ndr\i:	lo:ndr\i:
disagreeable	dIs@gr\i:@bl	dIs@gr\i:@b@l
wheelchair	wi:ltSe@	wi:ltSe:
course	k@:s	ko:s
tore	t@:	to:
overhaul	@}v@h@:l	@}v@ho:l
haughty	h@:ti:	ho:ti:
torn	t@:n	to:n
thereby	De@bAe	De:bAe
in-laws	In-l@:z	Inlo:z
revert	r\@v@:t	r\@v3:t
quarter	kw@:t@	kwo:t@
quartet	kw@:tet	kwo:tet
trauma	tr\@:m@	tr\o:m@
formula	f@:mj@l@	fo:mj@l@
hairdresser	he@dr\es@	he:dr\es@
initiate	InISi:{It	@nISi:{It
P-plate	pi:-pl{It	pi:pl{It
clause	kl@:z	klo:z
hair-raising	he@r\{IzIN	he:r\{IzIN
extortion	@kst@:S@n	@ksto:S@n
shawl	S@:l	So:l
boyfriend	b@:Ifr\end	boIfr\end
iceberg	Aesb@:g	Aesb3:g
destroy	d@str\@:I	d@str\oI
discerning	dIs@:nIN	d@s3:nIN
Portuguese	p@:tS@gi:z	po:tS@gi:z
lawn	l@:n	lo:n
average	{v@r\IdZ	{vr\IdZ
pile-up	pAel-6p	pAel6p
surplus	s@:pl@s	s3:pl@s
far-reaching	f6:-r\i:tSIN	f6:r\i:tSIN
scarce	ske@s	ske:s
dissimilar	dIsIm@l@	dIssIm@l@
submerge	s@bm@:dZ	s@bm3:dZ
resource	r\@z@:s	r\@zo:s
landlord	l{ndl@:d	l{ndlo:d
where	we@	we:
surgery	s@:dZ@r\i:	s3:dZ@r\i:
mutton	m6tn	m6t@n
dormitory	d@:m@tr\i:	do:m@tr\i:
vertical	v@:tIk@l	v3:tIk@l
spare	spe@	spe:
jaunty	dZ@:nti:	dZo:nti:
mosaic	m@z{IIk	m@}z{IIk
riddle	r\Idl	r\Id@l
vacation	v@k{IS@n	v{Ik{IS@n
almighty	@:lmAeti:	o:lmAeti:
prototype	pr\@}t@tAep	pr\@}t@}tAep
observe	@bz@:v	@bz3:v
former	f@:m@	fo:m@
girth	g@:T	g3:T
aluminium	{lj@mInj@m	{lj@mIni:@m
purse	p@:s	p3:s
cock-up	kOk-6p	kOk6p
workout	w@:k{Ot	w3:k{Ot
advertisement	@dv@:t@sm@nt	@dv3:t@sm@nt
by-product	bAe-pr\Od6kt	bAepr\Od6kt
disconcert	dIsk@ns@:t	dIsk@ns3:t
disperse	dIsp@:s	d@sp3:s
world	w@:ld	w3:ld
dare	de@	de:
claw	kl@:	klo:
wattle	wOtl	wOt@l
moreover	m@:r\@}v@	mo:r\@}v@
there'll	De@l	De:l
exit	egz@t	eks@t
pentathlon	pent{Tl@n	pent{TlOn
refer	r\@f@:	r\@f3:
averse	@v@:s	@v3:s
poise	p@:Iz	poIz
tortuous	t@:tS}:@s	to:tS}:@s
burglar	b@:gl@	b3:gl@
her	h@:	h3:
NE	n@:Ti:st	no:Ti:st
NW	n@:Twest	no:Twest
flirt	fl@:t	fl3:t
dirty	d@:ti:	d3:ti:
reprimand	r\epr\@m6:nd	r\epr\@m{nd
certain	s@:tn	s3:t@n
bookstall	bUkst@:l	bUksto:l
Thursday	T@:zd{I	T3:zd{I
follow-up	fOl@}-6p	fOl@}6p
worn-out	w@:n-{Ot	wo:n{Ot
first-class	f@:st-kl6:s	f3:stkl6:s
p.a.	p@:r\{n@m	p3:r\{n@m
ringworm	r\INw@:m	r\INw3:m
welfare	welfe@	welfe:
urbane	@:b{In	3:b{In
appointment	@p@:Intm@nt	@poIntm@nt
baton	b{tn	b{t@n
dinosaur	dAen@s@:	dAen@so:
small	sm@:l	smo:l
joiner	dZ@:In@	dZoIn@
burnish	b@:nIS	b3:nIS
nurse	n@:s	n3:s
overawe	@}v@r\@:	@}v@r\o:
shorthand	S@:th{nd	So:th{nd
indoors	Ind@:z	Indo:z
implore	Impl@:	Implo:
gorgeous	g@:dZ@s	go:dZ@s
more	m@:	mo:
drawcard	dr\@:k6:d	dr\o:k6:d
door	d@:	do:
mall	m@:l	mo:l
learn	l@:n	l3:n
autumn	@:t@m	o:t@m
occur	@k@:	@k3:
authentic	@:TentIk	o:TentIk
resemble	r\@zembl	r\@zemb@l
volleyball	vOli:b@:l	vOli:bo:l
fundamental	f6nd@mentl	f6nd@ment@l
stone-cold	st@}n-k@}ld	st@}nk@}ld
sauce	s@:s	so:s
always	@:lw{Iz	o:lw{Iz
warped	w@:pt	wo:pt
upstairs	6pste@z	6pste:z
clockwork	klOkw@:k	klOkw3:k
mark-up	m6:k-6p	m6:k6p
research	r\@s@:tS	r\@s3:tS
bloody-minded	bl6di:-mAend@d	bl6di:mAend@d
murmur	m@:m@	m3:m@
imagine	Im{dZ@n	@m{dZ@n
thereafter	De@r\6:ft@	De:r\6:ft@
number	n6m@	n6mb@
bedridden	bedr\Idn	bedr\Id@n
immediate	Imi:di:@t	@mi:di:@t
determiner	d@t@:m@n@	d@t3:m@n@
determined	d@t@:m@nd	d@t3:m@nd
ex-	eks-	eks
heterosexual	het@r\@}sekS}:@l	het@r\@sekS}:@l
self-service	self-s@:v@s	selfs3:v@s
also	@:ls@}	o:ls@}
hurtle	h@:tl	h3:t@l
blackboard	bl{kb@:d	bl{kbo:d
yawn	j@:n	jo:n
model	mOdl	mOd@l
oyster	@:Ist@	oIst@
exterminate	@kst@:m@n{It	@kst3:m@n{It
downpour	d{Onp@:	d{Onpo:
well-off	wel-Of	welOf
bird	b@:d	b3:d
bluebottle	bl}:bOtl	bl}:bOt@l
overwhelm	@}v@welmd	@}v@welm
nibble	nIbl	nIb@l
potent	p@}tnt	p@}t@nt
overboard	@}v@b@:d	@}v@bo:d
contour	kOnt@:	kOntU@
crossword	kr\Osw@:d	kr\Osw3:d
forklift	f@:klIft	fo:klIft
church	tS@:tS	tS3:tS
indefinite	Indefn@t	Indef@n@t
instalment	Inst@:lm@nt	Insto:lm@nt
drink-driving	dr\INk-dr\AevIN	dr\INkdr\AevIN
firm	f@:m	f3:m
champion	tS{mpj@n	tS{mpi:@n
deport	d@p@:t	d@po:t
far-sighted	f6:-sAet@d	f6:sAet@d
triple	tr\Ipl	tr\Ip@l
decor	d{Ik@:	d{Iko:
decoy	di:k@:I	di:koI
shorten	S@:t@n	So:t@n
alert	@l@:t	@l3:t
make-believe	m{Ik-b@li:v	m{Ikb@li:v
doily	d@:Ili:	doIli:
sandal	s{ndl	s{nd@l
emergency	@m@:dZ@nsi:	@m3:dZ@nsi:
format	f@:m{t	fo:m{t
chorus	k@:r\@s	ko:r\@s
disorder	dIs@:d@	dIso:d@
sorbet	s@:b{I	so:b{I
mortuary	m@:tS@r\i:	mo:tS@r\i:
repair	r\@pe@	r\@pe:
check-up	tSek-6p	tSek6p
impudent	Impj}:d@nt	Impj@d@nt
elsewhere	elswe@	elswe:
mature	m@tS@:	m@tSU@
tautology	t@:tOl@dZi:	to:tOl@dZi:
haunt	h@:nt	ho:nt
diverse	dAev@:s	dAev3:s
nationalise	n{Sn@lAez	n{S@n@lAez
nationalism	n{Sn@lIzm	n{S@n@lIzm
nettle	netl	net@l
furthest	f@:D@st	f3:D@st
moor	m@:	mo:
garden	g6:dn	g6:d@n
torture	t@:tS@	to:tS@
henceforth	hensf@:T	hensfo:T
wishy-washy	wISi:-wOSi:	wISi:wOSi:
second-rate	sek@nd-r\{It	sek@ndr\{It
certificate	s@tIfIk@t	s@tIf@k@t
gherkin	g@:k@n	g3:k@n
pour	p@:	po:
pawn	p@:n	po:n
wallpaper	w@:lp{Ip@	wo:lp{Ip@
hawk	h@:k	ho:k
autograph	@:t@gr\{f	o:t@gr\{f
bursar	b@:s@	b3:s@
perfect	p@:fekt	p3:fIkt
decay	di:k{I	d@k{I
dispose	dIsp@}z	d@sp@}z
transparent	tr\{nspe@r\@nt	tr\{nzpe:r\@nt
merge	m@:dZ	m3:dZ
shortage	S@:tIdZ	So:tIdZ
scorch	sk@:tS	sko:tS
thirteen	T@:ti:n	T3:ti:n
footwear	fUtwe@	fUtwe:
borderline	b@:d@lAen	bo:d@lAen
hilarious	h@le@r\i:@s	h@le:r\i:@s
unwieldy	6nwIldi:	6nwI@ldi:
surely	S@:li:	So:li:
sanatorium	s{n@t@:r\i:@m	s{n@to:r\i:@m
scare	ske@	ske:
prank	pr\6:Nk	pr\{Nk
dead-end	de-end	dedend
warfare	w@:fe@	wo:fe:
gentle	dZentl	dZent@l
fourteenth	f@:ti:nT	fo:ti:nT
off-peak	Of-pi:k	Ofpi:k
soar	s@:	so:
worldwide	w@:ldwAed	w3:ldwAed
medal	medl	med@l
fervent	f@:v@nt	f3:v@nt
dissociate	dIs@}si:{It	dIss@}si:{It
manchester	m{ntS@st@	m{ntSest@
decade	dk{Id	dek{Id
pause	p@:z	po:z
jaw	dZ@:	dZo:
terminal	t@:m@n@l	t3:m@n@l
handle	h{ndl	h{nd@l
stand-by	st{nd-bAe	st{ndbAe
terminus	t@:m@n@s	t3:m@n@s
heartburn	h6:tb@:n	h6:tb3:n
airmail	e@m{Il	e:m{Il
pistol	pIstl	pIst@l
disgruntled	dIsgr\6ntld	dIsgr\6nt@ld
courtyard	k@:tj6:d	ko:tj6:d
galore	g@l@:	g@lo:
distil	dIstIl	d@stIl
entitle	entAetl	entAet@l
maul	m@:l	mo:l
groin	gr\@:In	gr\oIn
vs	v@:s@s	v3:s@z
conserve	k@ns@:v	k@ns3:v
glaring	gle@r\IN	gle:r\IN
overalls	@}v@r\@:lz	@}v@r\o:lz
audit	@:d@t	o:d@t
diversify	d@v@:s@fAe	d@v3:s@fAe
audio	@:di:@}	o:di:@}
taunt	t@:nt	to:nt
haul	h@:l	ho:l
premature	pr\em@tS@	pr\em@tSU@
immortal	Im@:t@l	Imo:t@l
transport	tr\{nsp@:t	tr\{nspo:t
avoid	@v@:Id	@voId
saucepan	s@:sp@n	so:sp@n
hooligan	h}:l@g@n	h}:li:g@n
imaginary	Im{dZ@n@r\i:	@m{dZ@nr\i:
gallstone	g@:lst@}n	go:lst@}n
negotiable	neg@}Si:@bl	neg@}S@b@l
funnel	f6nl	f6n@l
cosmopolitan	kOzm@pOl@tn	kOzm@pOl@t@n
taciturn	t{s@t@:n	t{s@t3:n
spiritual	spIr\ItS}:@l	spIr\@tS@l
baptism	b{ptIzm	b{ptIz@m
bearing	be@r\IN	be:r\IN
father-in-law	f6:D@r\-In-l@:	f6:D@r\Inlo:
illusion	Il}:Z@n	@l}:Z@n
dismantle	dIsm{ntl	dIsm{nt@l
in-	In-	In
mercenary	m@:s@nr\i:	m3:s@nr\i:
rural	r\U@r\@l	r\}:r\@l
buoy	b@:I	boI
suicidal	s}:@sAedl	s}:@sAed@l
desirable	d@zAe@r\@bl	d@zAer\@b@l
nursery	n@:s@r\i:	n3:s@r\i:
grandparent	gr\{npe@r\@nt	gr\{npe:r\@nt
defraud	d@fr\@:d	d@fr\o:d
oriental	@:r\i:entl	o:r\i:ent@l
blanket	bl6:Nk@t	bl{Nk@t
distort	d@st@:t	d@sto:t
waterlogged	w@:t@lOgd	wo:t@lOgd
heliport	heli:p@:t	heli:po:t
horn	h@:n	ho:n
hire-purchase	hAe@-p@:tS@s	hAe@p3:tS@s
moratorium	mOr\@t@:r\i:@m	mOr\@to:r\i:@m
toll	t@}l	tOl
hairdo	he@d}:	he:d}:
daughter	d@:t@	do:t@
ploy	pl@:I	ploI
scary	ske@r\i:	ske:r\i:
award	@w@:d	@wo:d
aware	@we@	@we:
word	w@:d	w3:d
wore	w@:	wo:
err	@:	3:
divorcee	d@v@:si:	d@vo:si:
defuse	di:fj}:z	d@fj}:z
work	w@:k	w3:k
worm	w@:m	w3:m
worn	w@:n	wo:n
cuddle	k6dl	k6d@l
mortar	m@:t@	mo:t@
impair	Impe@	Impe:
morbid	m@:b@d	mo:b@d
moron	m@:r\On	mo:r\On
disappoint	dIs@p@:Int	dIs@poInt
ordinary	@:d@n@r\i:	o:d@n@r\i:
law	l@:	lo:
worst	w@:st	w3:st
order	@:d@	o:d@
mayor	me@	me:
somewhere	s6mwe@	s6mwe:
carton	k6:tn	k6:t@n
versus	v@:s@s	v3:s@z
hostel	hOst@l	hOstel
network	netw@:k	netw3:k
forty	f@:ti:	fo:ti:
forte	f@:t{I	fo:t{I
forth	f@:T	fo:T
forcible	f@:s@b@l	fo:s@b@l
warden	w@:d@n	wo:d@n
hearse	h@:s	h3:s
fumble	f6mbl	f6mb@l
paltry	p@:ltr\i:	po:ltr\i:
mercy	m@:si:	m3:si:
kung-fu	k6N-f}:	k6Nf}:
self-confident	self-kOnf@d@ns	selfkOnf@d@ns
strength	str\eNT	str\eNkT
casual	k{Zj}:@l	k{Z}:@l
maiden	m{Idn	m{Id@n
autopsy	@:tOpsi:	o:tOpsi:
kilohertz	kIl@h@:ts	kIl@h3:ts
mitten	mItn	mIt@n
precarious	pr\@ke@r\i:@s	pr\@ke:r\i:@s
dermatitis	d@:m@tAet@s	d3:m@tAet@s
personality	p@:s@n{l@ti:	p3:s@n{l@ti:
freshwater	fr\eSw@:t@	fr\eSwo:t@
compere	kOmpe@	kOmpe:
cattle	k{tl	k{t@l
pastel	p{stl	p{st@l
gentleman	dZentlm@n	dZent@lm@n
drawn	dr\@:n	dr\o:n
drawl	dr\@:l	dr\o:l
accord	@k@:d	@ko:d
termite	t@:mAet	t3:mAet
convertible	k@nv@:t@bl	k@nv3:t@b@l
royal	r\@:I@l	r\oI@l
Vic.	vIkt@:r\i:@	vIkto:r\i:@
scarecrow	ske@kr\@}	ske:kr\@}
concerning	k@ns@:nIN	k@ns3:nIN
hacksaw	h{ks@:	h{kso:
hoist	h@:Ist	hoIst
clairvoyant	kle@v@:I@nt	kle:voI@nt
air	e@	e:
pig-headed	pIg-hed@d	pIghed@d
smorgasbord	sm@:g@zb@:d	smo:g@sbo:d
patent	p{Itnt	p{It@nt
authorise	@:T@r\Aez	o:T@r\Aez
thyroid	TAer\@:Id	TAer\oId
cervix	s@:vIks	s3:vIks
board	b@:d	bo:d
bindi-eye	bIndi:-Ae	bIndi:Ae
born	b@:n	bo:n
bore	b@:	bo:
purple	p@:p@l	p3:p@l
confer	k@nf@:	k@nf3:
posy	p@}:zi:	p@}zi:
herpes	h@:pi:z	h3:pi:z
theirs	De@z	De:z
tarpaulin	t6:p@:l@n	t6:po:l@n
thermostat	T@:m@st{t	T3:m@st{t
formidable	f@:m@d@b@l	fo:m@d@b@l
accordingly	@k@:dINli:	@ko:dINli:
war	w@:	wo:
converse	kOnv@:s	kOnv3:s
dying	dAeN	dAeIN
disloyal	dIsl@:I@l	dIsloI@l
roller-skate	r\@}l@-sk{It	r\@}l@sk{It
multiple-choice	m6lt@pl-tS@:Is	m6lt@p@ltSoIs
chairperson	tSe@p@:sn	tSe:p3:s@n
loyal	l@:I@l	loI@l
battle	b{tl	b{t@l
certainly	s@:tnli:	s3:t@nli:
dissatisfied	dIs{tIsfAed	dIss{t@sfAed
terminate	t@:m@n{It	t3:m@n{It
kitten	kItn	kIt@n
trouble	tr\6bl	tr\6b@l
discrete	dIskr\i:t	d@skr\i:t
diarrhoea	dAe@r\i:@	dAe@r\I@
hydro-electric	hAedr\@}-@lektr\Ik	hAedr\@}@lektr\Ik
discover	dIsk6v@	d@sk6v@
free-for-all	fr\i:-f@r\-@:l	fr\i:f@r\o:l
curse	k@:s	k3:s
gawk	g@:k	go:k
gorge	g@:dZ	go:dZ
pictorial	pIkt@:r\i:@l	pIkto:r\i:@l
seashore	si:S@:	si:So:
purge	p@:dZ	p3:dZ
waterski	w@:t@ski:	wo:t@ski:
abort	@b@:t	@bo:t
staircase	ste@k{Is	ste:k{Is
push-up	pUS-6p	pUS6p
bawl	b@:l	bo:l
typical	tIpIkl	tIpIk@l
serving	s@:vIN	s3:vIN
forfeit	f@:f@t	fo:f@t
haircut	he@k6t	he:k6t
cul-de-sac	k6l-d@-s{k	k6ld@s{k
centenary	senti:n@r\i:	senten@r\i:
nought	n@:t	no:t
halt	h@:lt	ho:lt
hall	h@:l	ho:l
servant	s@:v@nt	s3:v@nt
furtive	f@:tIv	f3:tIv
kerb	k@:b	k3:b
mixed-up	mIkst-6p	mIkst6p
yeah	je@	je:
thirst	T@:st	T3:st
care	ke@	ke:
support	s@p@:t	s@po:t
so-and-so	s@}-@n-s@}	s@}@ns@}
municipality	mj}:n@s@p{l@ti:	mj}:nIs@p{l@ti:
yourself	j@:self	jo:self
caught	k@:t	ko:t
short	S@:t	So:t
surname	s@:n{Im	s3:n{Im
saute	s@}t{I	so:t{I
windsurf	wInds@:f	wInds3:f
callgirl	k@:lg@:l	ko:lg3:l
haemorrhoid	hem@r\@:i:d	hem@r\oId
aerosol	e@r\@sOl	e:r\@sOl
pattern	p{tn	p{t@n
startle	st6:tl	st6:t@l
stair	ste@	ste:
title	tAetl	tAet@l
proportion	pr\@p@:S@n	pr\@po:S@n
amputee	{mpj}:ti:	{mpj@ti:
superb	s@p@:b	s@p3:b
burst	b@:st	b3:st
hypodermic	hAep@d@:mIk	hAep@d3:mIk
sport	sp@:t	spo:t
concern	k@ns@:n	k@ns3:n
import	Imp@:t	Impo:t
guffaw	g6f@:	g6fo:
aura	@:r\@	o:r\@
downtrodden	d{Ontr\Odn	d{Ontr\Od@n
dispatch	dIsp{tS	d@sp{tS
exploit	@kspl@:It	@ksploIt
tropical	tr\OpIkl	tr\OpIk@l
down-market	d{On-m6:k@t	d{Onm6:k@t
external	@kst@:n@l	@kst3:n@l
editorial	ed@t@:r\i:@l	ed@to:r\i:@l
alcoholic	{lIk	{lk@hOlIk
soil	s@:Il	soIl
northward	n@:Tw@d	no:Tw@d
noble	n@}bl	n@}b@l
coordinate	k@}@:d@n{It	k@}o:d@n{It
valuable	v{lj}:b@l	v{lj@b@l
maternity	m@t@:n@ti:	m@t3:n@ti:
verse	v@:s	v3:s
spectacular	spekt{kjUl@	spekt{kj@l@
early	@:li:	3:li:
earnest	@:n@st	3:n@st
fortune	f@:tS@n	fo:tS@n
untangle	6nt{Ngl	6nt{Ng@l
verbal	v@:b@l	v3:b@l
questionnaire	kwestS@ne@	kwestS@ne:
squirm	skw@:m	skw3:m
perverse	p@v@:s	p@v3:s
conservative	k@ns@:v@tIv	k@ns3:v@tIv
squirt	skw@:t	skw3:t
tuition	tj}:ISn	tj}:IS@n
journey	dZ@:ni:	dZ3:ni:
your	j@:	jo:
stare	ste@	ste:
prepare	pr\@pe@	pr\@pe:
area	e@r\i:@	e:r\i:@
cold-blooded	k@}ld-bl6d@d	k@}ldbl6d@d
immaculate	Im{kj}:l@t	@m{kj@l@t
recoil	r\@k@:Il	r\@koIl
corduroy	k@:dZ@r\@:I	ko:d@r\oI
fraud	fr\@:d	fr\o:d
circulation	s@:kj@l{IS@n	s3:kj@l{IS@n
nerd	n@:d	n3:d
storage	st@:r\IdZ	sto:r\IdZ
housework	h{Osw@:k	h{Osw3:k
poor	p@:	po:
assert	@s@:t	@s3:t
skeleton	skel@tn	skel@t@n
groundwork	gr\{Ondw@:k	gr\{Ondw3:k
thoughtful	T@:tfUl	To:tfUl
duty-free	dj}:ti:-fr\i:	dj}:ti:fr\i:
corps	k@:	ko:
verb	v@:b	v3:b
hold-up	h@}ld-6p	h@}ld6p
curdle	k@:dl	k3:d@l
orgasm	@:g{z@m	o:g{z@m
penalise	pi:n@lAez	pen@lAez
Latin	l{tn	l{t@n
lurch	l@:tS	l3:tS
vegetarian	vedZ@te@r\i:@n	vedZ@te:r\i:@n
rort	r\@:t	r\o:t
mouth-watering	m{OT-w@:t@r\IN	m{OTwo:t@r\IN
take-off	t{Ik-Of	t{IkOf
self-conscious	self-kOnS@s	selfkOnS@s
boycott	b@:IkOt	boIkOt
horizontal	hOr\@zOntl	hOr\@zOnt@l
morphine	m@:fi:n	mo:fi:n
auburn	@:b@n	o:b@n
racecourse	r\{Isk@:s	r\{Isko:s
fairy	fe@r\i:	fe:r\i:
thirteenth	T@:ti:nT	T3:ti:nT
bald	b@:ld	bo:ld
dirt	d@:t	d3:t
launch	l@:ntS	lo:ntS
nutritionist	nj}:tr\IS@ni:st	nj}:tr\IS@n@st
horse	h@:s	ho:s
impersonal	Imp@:s@n@l	Imp3:s@n@l
coleslaw	k@}lsl@:	k@}lslo:
affirmative	@f@:m@tIv	@f3:m@tIv
towards	t@w@:dz	t@wo:dz
promenade	pr\Om@n6:d	pr\Om@n{Id
anniversary	{n@v@:s@r\i:	{n@v3:s@r\i:
bridle	br\Aedl	br\Aed@l
hands-on	h{ndz-On	h{ndzOn
sturdy	st@:di:	st3:di:
roadworks	r\@}dw@:ks	r\@}dw3:ks
part-time	p6:t-tAem	p6:ttAem
ropeable	r\@}p@bl	r\@}p@b@l
wriggle	r\Igl	r\Ig@l
paranoia	p{r\@n@:I@	p{r\@noI@
circle	s@:k@l	s3:k@l
Medicare	medi:ke@	medi:ke:
molten	m@}ltn	m@}lt@n
immerse	Im@:s	@m3:s
nightshirt	nAetS@:t	nAetS3:t
perfume	p@:fj}:m	p3:fj}:m
after-hours	6:ft@r\-{O@z	6:ft@r\{O@z
courteous	k@:ti:@s	k3:ti:@s
plausible	pl@:z@b@l	plo:z@b@l
revolution	r\ev@l}:Sn	r\ev@l}:S@n
assertive	@s@:tIv	@s3:tIv
half-hearted	h6:f-h6:t@d	h6:fh6:t@d
gaunt	g@:nt	go:nt
Turkish	t@:kIS	t3:kIS
horticulture	h@:t@k6ltS@	ho:t@k6ltS@
coarse	k@:s	ko:s
c/o	ke@r\Ov	ke:r\Ov
determination	d@t@:m@n{IS@n	d@t3:m@n{IS@n
folklore	f@}kl@:	f@}klo:
dry-clean	dr\Ae-kli:n	dr\Aekli:n
petal	petl	pet@l
forebear	f@:be@	fo:be:
paid-up	p{Id-6p	p{Id6p
hallway	h@:lw{I	ho:lw{I
used	j}:st	j}:zd
assortment	@s@:tm@nt	@so:tm@nt
chore	tS@:	tSo:
chord	k@:d	ko:d
morsel	m@:s@l	mo:s@l
password	p6:sw@:d	p6:sw3:d
informal	Inf@:m@l	Info:m@l
chairman	tSe@m@n	tSe:m@n
manifest	m{n@f@st	m{n@fest
trade-in	tr\{Id-In	tr\{IdIn
terminology	t@:m@nOl@dZi:	t3:m@nOl@dZi:
urgent	@:dZ@nt	3:dZ@nt
abroad	@br\@:d	@br\o:d
perk	p@:k	p3:k
caretaker	ke@t{Ik@	ke:t{Ik@
authority	@:TOr\@ti:	o:TOr\@ti:
quorum	kw@:r\@m	kwo:r\@m
reservation	r\ez@v{ISn	r\ez@v{IS@n
formal	f@:m@l	fo:m@l
everywhere	evr\i:we@	evr\i:we:
virtue	v@:tS}:	v3:tS}:
nausea	n@:si:@	no:zi:@
verdict	v@:dIkt	v3:dIkt
noise	n@:Iz	noIz
pornography	p@:nOgr\@fi:	po:nOgr\@fi:
deputation	depj}:t{IS@n	depj@t{IS@n
colonel	k@:n@l	k3:n@l
commercial	k@m@:S@l	k@m3:S@l
convert	k@nv@:t	k@nv3:t
foresee	f@:si:	fo:si:
metaphor	met@f@	met@fo:
vehicle	vi:Ik@l	vI@k@l
exhaustive	@gz@:stIv	@gzo:stIv
wharf	w@:f	wo:f
red-back	r\ed-b{k	r\edb{k
serviceable	s@:v@s@b@l	s3:v@s@b@l
sought	s@:t	so:t
skirt	sk@:t	sk3:t
waterproof	w@:t@pr\}:f	wo:t@pr\}:f
lurgy	l@:gi:	l3:gi:
perspire	p@spAe@	p3:spAe@
fare	fe@	fe:
by-law	bAe-l@:	bAelo:
sperm	sp@:m	sp3:m
brittle	br\Itl	br\It@l
sword	s@:d	so:d
university	j}:n@v@:s@ti:	j}:n@v3:s@ti:
tableware	t{Ib@lwe@	t{Ib@lwe:
illuminate	Il}:m@n{It	@l}:m@n{It
seesaw	si:s@:	si:so:
lukewarm	l}:kw@:m	l}:kwo:m
unlawful	6nl@:fUl	6nlo:fUl
cause	k@:z	ko:z
furore	fj}:r\@:	fj}:r\o:
airconditioning	e@k@ndIS@nIN	e:k@ndIS@nIN
precaution	pr\@k@:S@n	pr\@ko:S@n
fertiliser	f@:t@lAez@	f3:t@lAez@
ring-in	r\IN-In	r\INIn
ice-cream	Aes-kr\i:m	Aeskr\i:m
circulate	s@:kj@l{It	s3:kj@l{It
post-mortem	p@}st-m@:t@m	p@}stmo:t@m
spurt	sp@:t	sp3:t
daughter-in-law	d@:t@r\-In-l@:	do:t@r\Inlo:
torment	t@:ment	to:ment
portrait	p@:tr\@t	po:tr\@t
border	b@:d@	bo:d@
jaunt	dZ@:nt	dZo:nt
brother-in-law	br\6D@r\-In-l@:	br\6D@r\Inlo:
awe	@:	o:
urn	@:n	3:n
blurt	bl@:t	bl3:t
talk	t@:k	to:k
unsettle	6nsetl	6nset@l
versatile	v@:s@tAel	v3:s@tAel
joint	dZ@:Int	dZoInt
fallout	f@:l{Ot	fo:l{Ot
Italian	It{lj@n	@t{lj@n
orphan	@:f@n	o:f@n
reinforce	r\i:Inf@:s	r\i:Info:s
reinforcements	r\i:Inf@:sm@nts	r\i:Info:sm@nts
nightmare	nAetme@	nAetme:
hit-and-run	hIt-n-r\6n	hIt@nr\6n
self-centred	self-sent@d	selfsent@d
simple-minded	sImp@l-mAend@d	sImp@lmAend@d
foreshadow	f@:S{d@}	fo:S{d@}
jersey	dZ@:zi:	dZ3:zi:
subtitle	s6btAetl	s6btAet@l
immense	Imens	@mens
chalk	tS@:k	tSo:k
dinki-di	dINki:-dAe	dINki:dAe
surface	s@:f@s	s3:f@s
generic	dg@ner\Ik	dZ@ner\Ik
brick-veneer	br\Ik-v@nI@	br\Ikv@nI@
joist	dZ@:Ist	dZoIst
scarcely	ske@sli:	ske:sli:
surfboard	s@:fb@:d	s3:fbo:d
awning	@:nIN	o:nIN
restore	r\@st@:	r\@sto:
discord	dIsk@:d	dIsko:d
run-down	r\6n-d{On	r\6nd{On
morgue	m@:g	mo:g
ought	@:t	o:t
burden	b@:dn	b3:d@n
necessary	nes@s@r\i:	nes@ser\i:
Aug.	@:g@st	o:g@st
mornay	m@:n{I	mo:n{I
adversity	@dv@:s@ti:	@dv3:s@ti:
glare	gle@	gle:
broad	br\@:d	br\o:d
kettle	ketl	ket@l
eyesore	Aes@:	Aeso:
e-mail	i:-m{Il	i:m{Il
rewarding	r\@w@:dIN	r\@wo:dIN
percolate	p@:k@l{It	p3:k@l{It
across-the-board	@kr\Os-D@-b@:d	@kr\OsD@bo:d
inaccurate	In{kjUr\@t	In{kj@r\@t
journal	dZ@:n@l	dZ3:n@l
pointless	p@:Intl@s	poIntl@s
rejoice	r\@dZ@:Is	r\@dZoIs
north	n@:T	no:T
recorder	r\@k@:d@	r\@ko:d@
empty	emti:	empti:
display	dIspl{I	d@spl{I
universal	j}:n@v@:s@l	j}:n@v3:s@l
lyrebird	lAe@b@:d	lAe@b3:d
meteor	mi:ti:@	mi:ti:o:
foil	f@:Il	foIl
appoint	@p@:Int	@poInt
portion	p@:S@n	po:S@n
boilersuit	b@:Il@s}:t	boIl@s}:t
trodden	tr\Odn	tr\Od@n
appal	@p@:l	@po:l
void	v@:Id	voId
embroider	embr\@:Ud@	embr\oId@
convenience	k@nvi:nj@ns	k@nvi:ni:@ns
force	f@:s	fo:s
subordinate	s@b@:d@n@t	s@bo:d@n@t
gawky	g@:ki:	go:ki:
orchestra	@:k@str\@	o:k@str\@
disposable	dIsp@}z@bl	d@sp@}z@b@l
second-hand	sek@nd-h{nd	sek@ndh{nd
cardboard	k6:db@:d	k6:dbo:d
interpret	Int@:pr\@t	Int3:pr\@t
harass	h{r\@s	h@r\{s
jamb	dZIm	dZ{m
jaywalk	dZ{Iw@:k	dZ{Iwo:k
head-on	hed-On	hedOn
wary	we@r\i:	we:r\i:
warp	w@:p	wo:p
warm	w@:m	wo:m
ward	w@:d	wo:d
flora	fl@:r\@	flo:r\@
worth	w@:T	w3:T
defer	d@f@:	d@f3:
waterfront	w@:t@fr\6nt	wo:t@fr\6nt
shirt	S@:t	S3:t
purchase	p@:tS@s	p3:tS@s
third	T@:d	T3:d
fortify	f@:t@fAe	fo:t@fAe
keyboard	ki:b@:d	ki:bo:d
before	b@f@:	b@fo:
personal	p@:s@n@l	p3:s@n@l
unemployed	6n@mpl@:Id	6n@mploId
shirk	S@:k	S3:k
taught	t@:t	to:t
dawn	d@:n	do:n
resume	r\@zj}:m	r\eZ@m{I
domesticate	d@mestIk{It	d@mest@k{It
naughty	n@:ti:	no:ti:
hoof	h}:f	hUf
delirious	d@lIr\i:@s	d@lI@r\i:@s
escort	@sk@:t	@sko:t
peculiar	p@kj}:li:@	p@kj}:lj@
fairytale	fe@r\i:t{Il	fe:r\i:t{Il
loiter	l@:It@	loIt@
threadbare	Tr\edbe@	Tr\edbe:
far-fetched	f6:-fetSt	f6:fetSt
rattle	r\{tl	r\{t@l
modern	mOdn	mOd@n
churn	tS@:n	tS3:n
horde	h@:d	ho:d
machinery	m@S@i:n@r\i:	m@Si:n@r\i:
ensure	enS@:	enSo:
broadcast	br\@:dk6:st	br\o:dk6:st
discourteous	dIsk@:ti:@s	dIsk3:ti:@s
way-out	w{I-{Ot	w{I{Ot
negligible	negl@dZ@bl	negl@dZ@b@l
hoard	h@:d	ho:d
blur	bl@:	bl3:
earn	@:n	3:n
bugbear	b6gbe@	b6gbe:
monumental	mOnj@mentl	mOnj@ment@l
Christianity	kr\Isti:{n@ti:	kr\IstSi:{n@ti:
voyage	v@:IIdZ	voIIdZ
orthodontist	@:T@dOnt@st	o:T@dOnt@st
burble	b@:b@l	b3:b@l
initiative	InISi:@tIv	@nIS@tIv
recur	r\@k@:	r\@k3:
basis	b{Isi:z	b{Is@s
detrimental	detr\@mentl	detr\@ment@l
idol	Aedl	Aed@l
affirm	@f@:m	@f3:m
Persian	p@:Z@n	p3:Z@n
aeroplane	e@r\@pl{In	e:r\@pl{In
warder	w@:d@	wo:d@
yours	j@:z	jo:z
etiquette	etIk@t	eti:k@t
serviette	s@:vi:et	s3:vi:et
auspicious	@:spIS@s	o:spIS@s
discreet	dIskr\i:t	d@skr\i:t
hi-fi	hAe-fAe	hAefAe
nude	nj}:d	n}:d
disillusioned	dIsIl}:Z@nd	dIs@l}:Z@nd
notorious	n@t@:r\i:@s	n@to:r\i:@s
invoice	Inv@:Is	InvoIs
sprawl	spr\@:l	spr\o:l
dressing-table	dr\esIN-t{Ib@l	dr\esINt{Ib@l
uproar	6pr\@:	6pr\o:
bamboozle	b{mb}:zl	b{mb}:z@l
burl	b@:l	b3:l
burn	b@:n	b3:n
burp	b@:p	b3:p
burr	b@:	b3:
nerve	n@:v	n3:v
daub	d@:b	do:b
slurp	sl@:p	sl3:p
chime	tISAem	tSAem
initial	InIS@l	@nIS@l
stalk	st@:k	sto:k
fork	f@:k	fo:k
undergrowth	}:nd@gr\@}T	6nd@gr\@}T
form	f@:m	fo:m
January	dZ{nj}:@r\i:	dZ{nj@r\i:
fore	f@:	fo:
ford	f@:d	fo:d
syndicate	sIndIk@t	sInd@k@t
fort	f@:t	fo:t
disciplinarian	dIs@pl@ne@r\i:@n	dIs@pl@ne:r\i:@n
scrawl	skr\@:l	skr\o:l
self-defence	self-d@fens	selfd@fens
fraternal	fr\@t@:nl	fr\@t3:n@l
discriminate	dIskr\Im@n{It	d@skr\Im@n{It
bade	b{d	b{Id
warehouse	we@h{Os	we:h{Os
handicap	h{ndIk{p	h{ndi:k{p
outskirts	{Otsk@:ts	{Otsk3:ts
open-minded	@}p@n-mAend@d	@}p@nmAend@d
smallgoods	sm@:lgUdz	smo:lgUdz
customary	k6st@m@r\i:	k6st@mr\i:
woodwork	wUdw@:k	wUdw3:k
resourceful	r\@z@:sfUl	r\@zo:sfUl
biceps	bAes@ps	bAeseps
sordid	s@:d@d	so:d@d
dwarf	dw@:f	dwo:f
earthquake	@:Tkw{Ik	3:Tkw{Ik
boy	b@:I	boI
fortress	f@:tr\@s	fo:tr\@s
serpent	s@:p@nt	s3:p@nt
pert	p@:t	p3:t
olive	Ol@v	OlIv
off-colour	Of-k6l@	Ofk6l@
thermos	T@:mOs	T3:mOs
ripcord	r\Ipk@:d	r\Ipko:d
deceased	desIst	d@si:st
purr	p@:	p3:
swore	sw@:	swo:
sworn	sw@:n	swo:n
pin-up	pIn-6p	pIn6p
close-up	kl@}s-6p	kl@}s6p
tall	t@:l	to:l
bushwalk	bUSw@:k	bUSwo:k
hat-trick	h{t-tr\Ik	h{ttr\Ik
workload	w@:kl@}d	w3:kl@}d
careless	ke@l@s	ke:l@s
abnormal	{bn@:m@l	{bno:m@l
girl	g@:l	g3:l
morning	m@:nIN	mo:nIN
assurance	@S@:r\@ns	@So:r\@ns
underwear	6nd@we@	6nd@we:
language	l{NwIdZ	l{NgwIdZ
first	f@:st	f3:st
little	lItl	lIt@l
thoughtless	T@:tl@s	To:tl@s
murky	m@:ki:	m3:ki:
daunt	d@:nt	do:nt
mermaid	m@:m{Id	m3:m{Id
set-up	set-6p	set6p
orgy	@:dZi:	o:dZi:
fertilisation	f@:t@lAez{IS@n	f3:t@lAez{IS@n
were	w@:	w3:
efficient	@fISnt	@fIS@nt
pair	pe@	pe:
deportment	d@p@:tm@nt	d@po:tm@nt
corner	k@:n@	ko:n@
kernel	k@:n@l	k3:n@l
foreword	f@:w@:d	fo:w3:d
ornament	@:n@m@nt	o:n@m@nt
forecast	f@:k6:st	fo:k6:st
whereabouts	we@r\@b{Ots	we:r\@b{Ots
august	@:g6st	o:g6st
parent	pe@r\@nt	pe:r\@nt
bare	be@	be:
terse	t@:s	t3:s
mare	me@	me:
certify	s@:t@fAe	s3:t@fAe
workshop	w@:kSOp	w3:kSOp
forefinger	f@:fINg@	fo:fINg@
middle	mIdl	mId@l
sudden	s6dn	s6d@n
tour	t@:	tU@
aerobics	e@r\@}bIks	e:r\@}bIks
spring-clean	spr\IN-kli:n	spr\INkli:n
exhaust	@gz@:st	@gzo:st
oil	@:Il	oIl
diversion	d@v@:Z@n	d@v3:Z@n
walkover	w@:k@}v@	wo:k@}v@
vertebra	v@:t@br\@	v3:t@br\@
bottle	bOtl	bOt@l
asthma	6:sm@	{sm@
tourism	t@:r\Izm	tU@r\Iz@m
forge	f@:dZ	fo:dZ
chainsaw	tS{Ins@:	tS{Inso:
audience	@:di:@ns	o:di:@ns
confirm	k@nf@:m	k@nf3:m
notable	n@}t@bl	n@}t@b@l
finicky	fInIki:	fIn@ki:
son-in-law	s6n-In-l@:	s6nInlo:
roar	r\@:	r\o:
airline	e@lAen	e:lAen
point-blank	p@:Int-bl{Nk	poIntbl{Nk
jigsaw	dZIgs@:	dZIgso:
totalitarian	t@}t{l@te@r\i:@n	t@}t{l@te:r\i:@n
flamboyant	fl{mb@:I@nt	fl{mboI@nt
imagination	Im{dZ@n{IS@n	@m{dZ@n{IS@n
girlfriend	g@:lfr\end	g3:lfr\end
casualty	k{Zj}:@lti:	k{Z}:@lti:
personnel	p@:s@nel	p3:s@nel
hybrid	hAebr\Id	hAebr\@d
short-sighted	S@:t-sAet@d	So:tsAet@d
prism	pr\Izm	pr\Iz@m
astronaut	{str\@n@:t	{str\@no:t
important	Imp@:t@nt	Impo:t@nt
alright	@:lr\Aet	o:lr\Aet
diffuse	d@fj}:z	d@fj}:s
straightforward	str\{Itf@:w@d	str\{Itfo:w@d
knick-knack	nIk-n{k	nIkn{k
portable	p@:t@bl	po:t@b@l
lawyer	l@:j@	loI@
malaria	m@le@r\i:@	m@le:r\i:@
search	s@:tS	s3:tS
airport	e@p@:t	e:po:t
score	sk@:	sko:
recall	r\@k@:l	r\@ko:l
taut	t@:t	to:t
compare	k@mpe@	k@mpe:
hamburger	h{mb@:g@	h{mb3:g@
share	Se@	Se:
single-minded	sINg@l-mAend@d	sINg@lmAend@d
awkward	@:kw@d	o:kw@d
stir	st@:	st3:
orchard	@:tS@d	o:tS@d
toiletries	t@:Il@tr\i:z	toIl@tr\i:z
paw	p@:	po:
pitch-dark	pItS-d6:k	pItSd6:k
chirp	tS@:p	tS3:p
paternity	p@t@:n@ti:	p@t3:n@ti:
huddle	h6dl	h6d@l
boisterous	b@:Istr\@s	boIstr\@s
exquisite	ekskw@z@t	ekskwIz@t
forthright	f@:Tr\Aet	fo:Tr\Aet
mental	mentl	ment@l
foreground	f@:gr\{Ond	fo:gr\{Ond
circumstance	sek@mst{ns	s3:k@mst{ns
extraordinary	@kstr\@:d@nr\i:	@kstr\o:d@nr\i:
disposition	dIsp@zISn	dIsp@zIS@n
corkscrew	k@:kskr\}:	ko:kskr\}:
trickle	tr\Ikl	tr\Ik@l
perturb	p@t@:b	p@t3:b
barbarian	b6:be@r\i:@n	b6:be:r\i:@n
chipboard	tSIpb@:d	tSIpbo:d
colander	k6l@nd@	kOl@nd@
contrary	kOntr\@r\i:	kOntr\e:r\i:
gruelling	gr\}:@lIN	gr\}:lIN
declare	d@kle@	d@kle:
swerve	sw@:v	sw3:v
left-handed	left-h{nd@d	lefth{nd@d
murder	m@:d@	m3:d@
humanitarian	hj}:m{n@te@r\i:@n	hj}:m{n@te:r\i:@n
organism	@:g@nIz@m	o:g@nIz@m
nervous	n@:v@s	n3:v@s
batten	b{tn	b{t@n
semi-conscious	semi:-kOnS@s	semi:kOnS@s
Serbian	s@:bi:@n	s3:bi:@n
Jan.	dZ{nj}:@r\i:	dZ{nj@r\i:
merchandise	m@:tS@ndAes	m3:tS@ndAes
target	t{g@t	t6:g@t
cynical	sInIkl	sInIk@l
forthcoming	f@:Tk6mIN	fo:Tk6mIN
expert	eksp@:t	eksp3:t
distraught	dIstr\@:t	d@str\o:t
aircraft	e@kr\6:ft	e:kr\6:ft
scuttle	sk6tl	sk6t@l
full-time	fUl-tAem	fUltAem
point	p@:Int	poInt
dwindle	dwIndl	dwInd@l
toddle	tOdl	tOd@l
Khmer	k@me@	k@me:
tape-recorder	t{Ip-r\@k@:d@	t{Ipr\@ko:d@
horseshoe	h@:sS}:	ho:sS}:
hang-glider	h{N-glAed@	h{NglAed@
down-to-earth	d{On-t}:-@:T	d{Ont}:3:T
foul-mouthed	f{Ol-m{ODd	f{Olm{ODd
discourse	dIsk@:s	dIsko:s
corridor	kOr\@d@:	kOr\@do:
purpose	p@:p@s	p3:p@s
withdraw	wIDdr\@:	wIDdr\o:
malformation	m{lf@:m{IS@n	m{lfo:m{IS@n
alternate	Olt@:n@t	Olt3:n@t
source	s@:s	so:s
disrepair	dIsr\@pe@	dIsr\@pe:
scald	sk@:ld	sko:ld
culprit	k6lpr\It	k6lpr\@t
drip-dry	dr\Ip-dr\Ae	dr\Ipdr\Ae
forward	f@:w@d	fo:w@d
switchboard	swItSb@:d	swItSbo:d
aversion	@v@:Z@n	@v3:Z@n
autonomous	@:tOn@m@s	o:tOn@m@s
sort	s@:t	so:t
curt	k@:t	k3:t
partition	p@tIS@n	p6:tIS@n
metal	metl	met@l
curb	k@:b	k3:b
curl	k@:l	k3:l
mix-up	mIks-6p	mIks6p
reserve	r\@z@:v	r\@z3:v
drive-in	dr\Aev-In	dr\AevIn
cortisone	k@:t@z@}n	ko:t@z@}n
dessert	d@z@:t	d@z3:t
surgeon	s@:dZ@n	s3:dZ@n
moderate	mOdr\@t	mOd@r\@t
mottled	mOtld	mOt@ld
insubordinate	Ins@b@:d@n@t	Ins@bo:d@n@t
subtle	s6tl	s6t@l
pittance	pItns	pIt@ns
paddle	p{dl	p{d@l
access	6:kses	{kses
nimble	ni:mbl	nImb@l
dissuade	dIsw{Id	dIssw{Id
respiration	r\esp@r\{ISn	r\esp@r\{IS@n
implement	Impl@ment	Impl@m@nt
decrease	d@kr\Is	d@kr\i:s
scandal	sk{ndl	sk{nd@l
sermon	s@:m@n	s3:m@n
account	@k6:}:nt	@k6{Ont
reserved	r\@z@:vd	r\@z3:vd
waltz	w@:ls	wo:lts
bowerbird	b{O@b@:d	b{O@b3:d
furnace	f@:n@s	f3:n@s
sir	s@:	s3:
spin-dry	spIn-dr\Ae	spIndr\Ae
furnish	f@:nIS	f3:nIS
fertile	f@:tAel	f3:tAel
silkworm	sIlkw@:m	sIlkw3:m
decorum	d@k@:r\@m	d@ko:r\@m
kindergarten	kInd@g6:tn	kInd@g6:t@n
muddle	m6dl	m6d@l
deplore	d@pl@:	d@plo:
flair	fle@	fle:
thwart	Tw@:t	Two:t
baulk	b@:k	bo:k
maternal	m@t@:n@l	m@t3:n@l
thereupon	De@r\@pOn	De:r\@pOn
fourteen	f@:ti:n	fo:ti:n
perjure	p@:dZ@	p3:dZ@
mortal	m@:tl	mo:t@l
hurdle	h@:dl	h3:d@l
unscrupulous	6nskr\}:pjUl@s	6nskr\}:pj@l@s
absent-minded	{bs@nt-mAend@d	{bs@ntmAend@d
NT	n@:D@nter\@tr\i:	no:D@nter\@tr\i:
free-range	fr\i:-r\{IndZ	fr\i:r\{IndZ
mooring	m@:r\IN	mo:r\IN
absurd	@bs@:d	@bs3:d
portfolio	p@:tf@}li:@}	po:tf@}li:@}
wear	we@	we:
pitfall	pItf@:l	pItfo:l
bear	be@	be:
organ	@:g@n	o:g@n
national	n{Sn@l	n{S@n@l
reform	r\@f@:m	r\@fo:m
assure	@S@:	@So:
glorious	gl@:r\i:@s	glo:r\i:@s
aquarium	@kwe@r\i:@m	@kwe:r\i:@m
curtain	k@:t@n	k3:t@n
curtail	k@:t{Il	k3:t{Il
almost	@:lm@}st	o:lm@}st
dissent	dIsent	d@sent
impersonate	Imp@:s@n{It	Imp3:s@n{It
pedestal	ped@stl	ped@st@l
portray	p@:tr\{I	po:tr\{I
whirl	w@:l	w3:l
infer	Inf@:	Inf3:
whirr	w@:	w3:
garish	ge@r\IS	ge:r\IS
toil	t@:Il	toIl
sauna	s@:n@	so:n@
sunburn	s6nb@:n	s6nb3:n
insure	InS@:	InSo:
thought	T@:t	To:t
sister-in-law	sIst@r\-In-l@:	sIst@r\Inlo:
storey	st@:r\i:	sto:r\i:
royalty	r\@:I@lti:	r\oI@lti:
insert	Ins@:t	Ins3:t
porous	p@:r\@s	po:r\@s
journalist	dZ@:n@l@st	dZ3:n@l@st
audible	@:d@b@l	o:d@b@l
hair	he@	he:
supportive	s@p@:tIv	s@po:tIv
corpse	k@:ps	ko:ps
hurricane	h6r\@k@n	h6r\@k{In
discretion	dIskr\eS@n	d@skr\eS@n
conference	kOnf@r\@ns	kOnfr\@ns
although	@:lD@}	o:lD@}
worthy	w@:Di:	w3:Di:
earthenware	@:D@nwe@	3:D@nwe:
November	n@vemb@	n@}vemb@
genitals	dZen@tlz	dZen@t@lz
glory	gl@:r\i:	glo:r\i:
circus	s@:k@s	s3:k@s
corporation	k@:p@r\{IS@n	ko:p@r\{IS@n
oar	@:	o:
hydrofoil	hAedr\@f@:Il	hAedr\@foIl
bundle	b6ndl	b6nd@l
intransitive	Intr\{ns@tIv	Intr\{nz@tIv
resolution	r\ez@l}:Sn	r\ez@l}:S@n
dispense	dIspens	d@spens
lurk	l@:k	l3:k
enjoy	endZ@:I	endZoI
poison	p@:Iz@n	poIz@n
endorse	end@:s	endo:s
fall	f@:l	fo:l
jaundice	dZ@:nd@s	dZo:nd@s
wart	w@:t	wo:t
voice	v@:Is	voIs
forum	f@:r\@m	fo:r\@m
blowtorch	bl@}t@:tS	bl@}to:tS
old-fashioned	@}ld-f{S@nd	@}ldf{S@nd
hospital	hOsp@tl	hOsp@t@l
asset	{s@t	{set
adjourn	@dZ@:n	@dZ3:n
join	dZ@:In	dZoIn
watertight	w@:t@tAet	wo:t@tAet
burly	b@:li:	b3:li:
daredevil	de@dev@l	de:dev@l
salesperson	s{Ilzp@:sn	s{Ilzp3:s@n
deform	d@f@:m	d@fo:m
strangle	str\{Ngl	str\{Ng@l
bottleneck	bOtlnek	bOt@lnek
fairway	fe@w{I	fe:w{I
Judaism	dZ}:d{Iz@m	dZ}:d{IIz@m
tourist	t@:r\Ist	tU@r\@st
monarch	mOn@k	mOn6:k
disreputable	dIsr\epj@t@bl	dIsr\epj@t@b@l
victory	vIkt@r\i:	vIktr\i:
fraught	fr\@:t	fr\o:t
eternal	@t@:n@l	@t3:n@l
formation	f@:m{IS@n	fo:m{IS@n
suburbia	s@b@:bi:@	s@b3:bi:@
already	@:lr\edi:	o:lr\edi:
re-count	r\i:-k{Ont	r\i:k{Ont
primary	pr\Aem@r\i:	pr\Aemr\i:
mercury	m@:kj@r\i:	m3:kj@r\i:
toy	t@:I	toI
their	De@	De:
paediatrician	pi:di:@tr\ISn	pi:di:@tr\IS@n
urban	@:b@n	3:b@n
serve	s@:v	s3:v
incur	INk@:	INk3:
wardrobe	w@:dr\@}b	wo:dr\@}b
precocious	pr\ek@}S@s	pr\@k@}S@s
mirth	m@:T	m3:T
handkerchief	h{Nk@tS@f	h{Nk@tSi:f
raw	r\@:	r\o:
further	f@:D@	f3:D@
disorganised	dIs@:g@nAezd	dIso:g@nAezd
audition	@:dIS@n	o:dIS@n
coil	k@:Il	koIl
coin	k@:In	koIn
freeway	fr\Iw{I	fr\i:w{I
earth	@:T	3:T
peddle	pedl	ped@l
blue-collar	bl}:-kOl@	bl}:kOl@
baffle	b{fl	b{f@l
report	r\@p@:t	r\@po:t
overbearing	@}v@be@r\IN	@}v@be:r\IN
spokesperson	sp@}ksp@:s@n	sp@}ksp3:s@n
automatic	@:t@m{tIk	o:t@m{tIk
byword	bAew@:d	bAew3:d
paternal	p@t@:n@l	p@t3:n@l
gaudy	g@:di:	go:di:
break-in	br\{Ik-In	br\{IkIn
tolerable	tOlr\@bl	tOl@r\@b@l
dashboard	d{Sb@:d	d{Sbo:d
precede	pr\i:si:d	pr\@si:d
turquoise	t@:kw@:Iz	t3:kwoIz
drawback	dr\@:b{k	dr\o:b{k
suburb	s6b@:b	s6b3:b
shortly	S@:tli:	So:tli:
forceful	f@:sfUl	fo:sfUl
half-brother	h6:f-br\6D@	h6:fbr\6D@
aubergine	@}b@dZi:n	@}b@Zi:n
teetotal	ti:t@}tl	ti:t@}t@l
upturn	6pt@:n	6pt3:n
superlative	s}:p@:l@tIv	s@p3:l@tIv
scrabble	skr\{bl	skr\{b@l
cord	k@:d	ko:d
core	k@:	ko:
split-level	splIt-lev@l	splItlev@l
brawl	br\@:l	br\o:l
corn	k@:n	ko:n
cork	k@:k	ko:k
menopause	men@p@:z	men@po:z
trustworthy	tr\6stw@:Di:	tr\6stw3:Di:
entrepreneur	Ontr\@pr\@n@:	Ontr\@pr\@n3:
pearl	p@:l	p3:l
transform	tr\{nsf@:m	tr\{nsfo:m
bloodthirsty	bl6dT@:sti:	bl6dT3:sti:
virgin	v@:dZ@n	v3:dZ@n
lay-by	l{I-bAe	l{IbAe
fought	f@:t	fo:t
floorboard	fl@:b@:d	flo:bo:d
adore	@d@:	@do:
forearm	f@:r\6:m	fo:r\6:m
whereas	we@r\{z	we:r\{z
football	fUtb@:l	fUtbo:l
affair	@fe@	@fe:
discern	dIs@:n	d@s3:n
puddle	p6dl	p6d@l
wilful	wIlf@:l	wIlfUl
netball	netb@:l	netbo:l
airlift	e@lIft	e:lIft
pork	p@:k	po:k
pore	p@:	po:
up-market	6p-m6:k@t	6pm6:k@t
Nov.	n@vemb@	n@}vemb@
brawn	br\@:n	br\o:n
clergy	kl@:dZi:	kl3:dZi:
water	w@:t@	wo:t@
baseball	b{Isb@:l	b{Isbo:l
lawnmower	l@:nm@}@	lo:nm@}@
hoarse	h@:s	ho:s
emerge	@m@:dZ	@m3:dZ
Hungarian	h6Nge@r\i:@n	h6Nge:r\i:@n
memory	mem@r\i:	memr\i:
first-hand	f@:sth{nd	f3:sth{nd
in-patient	In-p{IS@nt	Inp{IS@nt
German	dZ@:m@n	dZ3:m@n
mortality	m@:t{l@ti:	mo:t{l@ti:
fauna	f@:n@	fo:n@
downfall	d{Onf@:l	d{Onfo:l
cornflakes	k@:nfl{Iks	ko:nfl{Iks
fourth	f@:T	fo:T
granddaughter	gr\{nd@:t@	gr\{ndo:t@
birthday	b@:Td{I	b3:Td{I
classroom	kl6:sr\Um	kl6:sr\}:m
inform	Inf@:m	Info:m
blare	ble@	ble:
mantlepiece	m{ntlpi:s	m{nt@lpi:s
worship	w@:SIp	w3:SIp
organisation	@:g@nAez{IS@n	o:g@nAez{IS@n
platform	pl{tf@:m	pl{tfo:m
swindle	swIndl	swInd@l
torch	t@:tS	to:tS
farewell	fe@wel	fe:wel
concur	k@Nk@:	k@Nk3:
intercourse	Int@k@:s	Int@ko:s
flare	fle@	fle:
talkback	t@:kb{k	to:kb{k
persecute	p@:s@kj}:t	p3:s@kj}:t
hurtful	h@:tfUl	h3:tfUl
tawdry	t@:dr\i:	to:dr\i:
dispensable	dIspens@bl	d@spens@b@l
nonflammable	nOnfl{m@bl	nOnfl{m@b@l
surf	s@:f	s3:f
urge	@:dZ	3:dZ
saunter	s@:nt@	so:nt@
aerodrome	e@r\@dr\@}m	e:r\@dr\@}m
perch	p@:tS	p3:tS
diverge	dAev@:dZ	dAev3:dZ
dawdle	d@:d@l	do:d@l
mortgage	m@:gIdZ	mo:gIdZ
caucus	k@:k@s	ko:k@s
armchair	6:mtSe@	6:mtSe:
poll	p@}	pOl
helicopter	hel@kOpt@	heli:kOpt@
reimburse	r\i:Imb@:s	r\i:Imb3:s
hernia	h@:ni:@	h3:ni:@
careful	ke@f@l	ke:f@l
dorm	d@:m	do:m
discrepancy	dIskr\ep@nsi:	d@skr\ep@nsi:
author	@:T@	o:T@
hermit	h@:m@t	h3:m@t
devoid	d@v@:Id	d@voId
foyer	f@:I@	foI@
reward	r\@w@:d	r\@wo:d
conform	k@nf@:m	k@nfo:m
satin	s{tn	s{t@n
furniture	f@:nItS@	f3:nItS@
snore	sn@:	sno:
snort	sn@:t	sno:t
shortcoming	S@:tk6mIN	So:tk6mIN
porter	p@:t@	po:t@
slaughter	sl@:t@	slo:t@
prattle	pr\{tl	pr\{t@l
or	@:	o:
determine	d@t@:m@n	d@t3:m@n
hoarding	h@:dIN	ho:dIN
there	De@	De:
disposed	dIsp@}zd	d@sp@}zd
thereabouts	De@r\@b{Ots	De:r\@b{Ots
show-off	S@}-Of	S@}Of
dressing-gown	dr\esIN-g{On	dr\esINg{On
toilet	t@:Il@t	toIl@t
surly	s@:li:	s3:li:
deserve	d@z@:v	d@z3:v
applause	@pl@:z	@plo:z
curve	k@:v	k3:v
all	@:l	o:l
fully-fledged	fUli:-fledZd	fUli:fledZd
write-off	r\Aet-@f	r\AetOf
dairy	de@r\i:	de:r\i:
worse	w@:s	w3:s
awful	@:f@l	o:f@l
sentimental	sent@mentl	sent@ment@l
manslaughter	m{nsl@:t@	m{nslo:t@
runner-up	r\6n@r\-6p	r\6n@r\6p
version	v@:Z@n	v3:Z@n
theatrical	Ti:{tr\@k@l	Ti:{tr\Ik@l
T-shirt	ti:-S@:t	ti:S3:t
flaw	fl@:	flo:
berth	b@:T	b3:T
forbearance	f@:be@r\@ns	fo:be:r\@ns
v	v@:s@s	v3:s@z
excursion	@ksk@:S@n	@ksk3:S@n
gnaw	n@:	no:
coerce	k@}@:s	k@}3:s
metamorphosis	met@m@:f@s@s	met@mo:f@s@s
mother-of-pearl	m6D@r\-@v-p@:l	m6D@r\@vp3:l
court	k@:t	ko:t
bawdy	b@:di:	bo:di:
disable	dIs{Ibl	dIs{Ib@l
meticulous	metIkj@l@s	m@tIkj@l@s
shore	S@:	So:
shorn	S@:n	So:n
flaunt	fl@:nt	flo:nt
resort	r\@z@:t	r\@zo:t
return	r\@t@:n	r\@t3:n
framework	fr\{Imw@:k	fr\{Imw3:k
sit-in	sIt-In	sItIn
belittle	b@lItl	b@lIt@l
formulate	f@:mj@l{It	fo:mj@l{It
causeway	k@:zw{I	ko:zw{I
scot-free	skOt-fr\i:	skOtfr\i:
absorb	@bs@:b	@bso:b
side-effects	sAed-@fekts	sAed@fekts
butcherbird	bUtS@b@:d	bUtS@b3:d
hardware	h6:dwe@	h6:dwe:
circuit	s@:k@t	s3:k@t
three-dimensional	Tr\i:-dmenS@n@l	Tr\i:d@menS@n@l
corporal	k@:p@r\@l	ko:pr\@l
story	st@:r\i:	sto:r\i:
gourmet	g@:mAe	go:m{I
automobile	@:t@m@bi:l	o:t@m@bi:l
swarm	sw@:m	swo:m
storm	st@:m	sto:m
second-class	sek@nd-kl6:s	sek@ndkl6:s
store	st@:	sto:
imperfect	i:mp@:fekt	Imp3:fekt
off-putting	Of-pUtIN	OfpUtIN
throttle	Tr\Otl	Tr\Ot@l
double	d6bl	d6b@l
stall	st@:l	sto:l
outdoors	{Otd@:z	{Otdo:z
exert	@gz@:t	@gz3:t
smallpox	sm@:lpOks	smo:lpOks
uproarious	6pr\@:r\i:@s	6pr\o:r\i:@s
port	p@:t	po:t
moist	m@:Ist	moIst
foreman	f@:m@n	fo:m@n
shareholder	Se@h@}ld@	Se:h@}ld@
washed-out	wOSt-{Ot	wOSt{Ot
babble	b{bl	b{b@l
hang-up	h{N-6p	h{N6p
bottlebrush	bOtlbr\6S	bOt@lbr\6S
merry-go-round	mer\i:-g@}-r\{Ond	mer\i:g@}r\{Ond
forlorn	f@l@:n	f@lo:n
various	ve@r\i:@s	ve:r\i:@s
downturn	